afford|负担得起
appreciate|欣赏；感激
appoint|任命，约定
approach|方法；靠近
appropriate|适当的，恰当的
approve|批准，赞成
approximately|大约，近似地
arise|出现；升起
arouse|引起，唤醒
assume|假定，承担
attach|附上，系上
attain|获得，达到
attribute|属性；归因于
available|可获得的，有空的
awkward|笨拙的；尴尬的
barrier|障碍，屏障
behave|表现，举止
beneficial|有益的，有利的
blame|责备，责怪
boost|提高，推动
bother|打扰，麻烦
brief|简短的，简洁的
budget|预算
campaign|运动，战役
candidate|候选人，报考者
capacity|容量；能力
casual|随意的，非正式的
cease|停止，终止
challenge|挑战，难题
characteristic|特征，特点
circumstance|情况，环境
collapse|倒塌，崩溃
collision|碰撞，冲突
combine|结合，联合
commit|犯（罪）；承诺
comparison|比较，对照
compensate|补偿，赔偿
competent|有能力的，能胜任的
complain|抱怨，投诉
complex|复杂的；复合的
component|组成部分，成分
compose|组成；作曲
comprehensive|全面的，综合的
compromise|妥协，折衷
conceal|隐藏，隐瞒
concentrate|集中；浓缩
concept|概念，观念
concern|关心；涉及
conclude|推断出；结束
concrete|具体的；混凝土
condemn|谴责，判刑
conduct|行为；引导
conference|会议，研讨会
confess|坦白，承认
confine|限制；监禁
confirm|确认，证实
conflict|冲突，矛盾
confront|面对，遭遇
confuse|使困惑；混淆
conscious|有意识的，神志清醒的
consent|同意，准许
conserve|保存，保护
considerable|相当大的，可观的
considerate|体贴的，考虑周到的
consist|由...组成
consistent|一致的，始终如一的
constant|不断的，持续的
constitute|组成，构成
consult|咨询，商量
consume|消耗，消费
contemporary|当代的，同时代的
contest|竞赛，比赛
context|上下文，语境
contract|合同；收缩
contrary|相反的；对立面
contrast|对比，对照
contribute|贡献；捐助
controversial|有争议的，引起争议的
convenient|方便的，便利的
conventional|传统的，常规的
convert|转变，转换
convey|表达，传达
convince|说服，使确信
coordinate|协调，调节
cope|应付，处理
correspond|符合；通信
council|理事会，委员会
counter|柜台；计数器
crack|裂缝；爆裂声
craft|工艺；手艺
crash|碰撞；坠毁
credit|信用；学分
crisis|危机，紧要关头
critical|关键的；批评的
criticize|批评，评论
crowd|人群；拥挤
crucial|至关重要的，决定性的
cultivate|培养，耕作
currency|货币，通货
current|当前的；水流
debate|辩论，争论
decade|十年，十年期
decline|下降，拒绝
decorate|装饰，装潢
decrease|减少，降低
dedicate|奉献，献身
defeat|击败，战胜
defend|防御，保卫
define|定义，界定
definite|明确的，一定的
delay|耽搁，延迟
delete|删除，删去
delicate|精致的，脆弱的
deliver|递送，发表
demonstrate|证明，示范
dense|密集的，稠密的
deny|否认，拒绝
depart|离开，出发
dependent|依赖的，依靠的
depress|使沮丧，压下
derive|源自，取得
descend|下降，下来
deserve|应得，值得
desirable|可取的，令人满意的
desperate|绝望的，孤注一掷的
despite|尽管，不管
destination|目的地，终点
destruction|破坏，毁灭
detect|察觉，发现
determine|决定，确定
device|设备，装置
devote|奉献，致力于
dialogue|对话，对白
dictate|口述；命令
digest|消化；摘要
digital|数字的，数码的
dignity|尊严，高贵
dilemma|困境，进退两难
dimension|尺寸，维度
discard|丢弃，抛弃
discharge|释放；排出
discipline|纪律；学科
discount|折扣
discourage|使泄气，阻碍
disguise|伪装，掩饰
disgust|厌恶，反感
dismiss|解雇；解散
disorder|混乱，骚乱
display|展示，陈列
dispose|处理，安排
dispute|争论，争端
dissolve|溶解；解散
distinct|清晰的，明显的
distinguish|区分，辨别
distribute|分配，分发
disturb|打扰，妨碍
diverse|多样的，不同的
divide|分开，划分
division|划分，部门
domestic|家庭的；国内的
dominate|支配，占优势
donate|捐赠，赠送
draft|草案，草图
dramatic|戏剧性的，引人注目的
drift|漂流，漂移
drown|溺死，淹没
duration|持续时间，期间
dynamic|动态的，有活力的
eager|渴望的，热切的
earnest|认真的，诚挚的
ease|容易，舒适
echo|回声，回音
economic|经济的，经济学的
economical|节约的，经济的
edition|版本，版
editor|编辑，编者
effective|有效的，起作用的
efficient|高效的，有能力的
elaborate|详尽的；精心制作的
elastic|有弹性的，灵活的
elect|选举，推选
elegant|优雅的，优美的
elementary|基本的，初级的
eliminate|消除，排除
embarrass|使尴尬，使为难
embrace|拥抱；欣然接受
emerge|浮现，出现
emergency|紧急情况，突发事件
emit|散发，发射
emotion|情感，情绪
emphasis|强调，重点
employ|雇佣，使用
enclose|围住，封入
encounter|遭遇，遇到
endure|忍受，忍耐
enforce|实施，执行
engage|从事，占用
enhance|提高，增强
enormous|巨大的，庞大的
ensure|确保，保证
entertain|娱乐，招待
enthusiasm|热情，热心
entitle|给...权利，给...题名
entry|进入，入口处
environment|环境，外界
episode|插曲，片段
equip|装备，配备
equivalent|相等的，等价物
era|时代，纪元
erect|竖立，建立
essential|必不可少的，本质的
establish|建立，设立
estimate|估计，估价
evaluate|评估，评价
evaporate|蒸发，挥发
eventual|最终的，最后的
evidence|证据，证明
evident|明显的，显然的
evil|邪恶的，罪恶的
evolution|进化，演变
exaggerate|夸大，夸张
exceed|超过，超出
excel|擅长，胜过
exception|例外，除外
excess|过量，过度
exchange|交换，交流
exclaim|呼喊，惊叫
exclude|排除，排斥
excursion|远足，短途旅行
execute|执行，处决
executive|行政的，执行官
exert|运用，发挥
exhaust|使筋疲力尽；排气
exhibit|展览，展示
exile|流放，流亡
expand|扩大，扩展
expel|驱逐，开除
expense|费用，开支
explode|爆炸，爆发
exploit|利用；剥削
explore|探索，勘探
export|出口，输出
expose|暴露，揭露
extend|延伸，延长
extent|程度，范围
extraordinary|非同寻常的，特别的
extreme|极度的，极端的
fabric|织物，结构
facility|设施，设备
factor|因素，要素
faculty|能力，系
fade|褪色，逐渐消失
failure|失败，失败者
faint|微弱的；头晕的
faith|信仰，信念
fancy|花哨的；想象
fantastic|极好的，奇异的
fare|车费，船费
fascinate|迷住，强烈吸引
fashionable|流行的，时髦的
fatal|致命的，毁灭性的
fatigue|疲劳，劳累
fault|错误，过失
favo(u)r|喜爱，赞成
feasible|可行的，可能的
feature|特征，特色
federal|联邦的，同盟的
fee|费用，酬金
fertile|肥沃的，多产的
fiction|小说，虚构
fierce|凶猛的，猛烈的
file|文件，档案
filter|过滤，筛选
finance|财政，金融
finite|有限的，有限度的
flame|火焰，火舌
flash|闪光，闪现
flavo(u)r|味道，风味
flee|逃跑，逃离
flexible|灵活的，柔韧的
flock|群集，聚集
flourish|繁荣，茂盛
fluctuate|波动，起伏
fluid|流体，液体
forbid|禁止，不许
forecast|预测，预报
forge|锻造，伪造
formal|正式的，正规的
format|格式，版式
formation|形成，构成
former|以前的，从前的
formula|公式，方程式
forth|向前，向外
foster|养育，培养
foundation|基础，基金会
fraction|小部分，分数
fragment|碎片，片段
framework|框架，结构
frank|坦率的，直率的
freight|货物，运费
frequency|频率，发生率
frequent|频繁的，经常的
friction|摩擦，摩擦力
frontier|边界，边境
frustrate|使沮丧，挫败
fulfill|履行，实现
function|功能，作用
fund|基金，资金
fundamental|基本的，根本的
furious|狂怒的，暴怒的
furnish|布置，提供
furthermore|此外，而且
fuss|大惊小怪，忙乱
gain|获得，赢得
gallery|画廊，走廊
gap|缺口，差距
garbage|垃圾，废物
garment|衣服，外衣
gasoline|汽油
gaze|凝视，注视
gear|齿轮，装置
generate|产生，引起
generous|慷慨的，大方的
genius|天才，天赋
genuine|真正的，真诚的
gesture|手势，姿势
giant|巨大的，巨人
glance|一瞥，扫视
glimpse|一瞥，一看
globe|地球，世界
glory|光荣，荣誉
glow|发光，发热
govern|统治，管理
grab|抓住，攫取
grace|优美，优雅
gradual|逐渐的，逐步的
graduate|毕业生；毕业
grain|谷物，颗粒
grant|授予，给予
graph|图表，曲线图
grasp|抓住，理解
grateful|感激的，感谢的
gratitude|感激，感谢
grave|严重的，重大的
gravity|重力，严重性
greedy|贪婪的，贪心的
greenhouse|温室，暖房
grind|磨碎，碾碎
grip|紧握，控制
gross|总的，毛的
guarantee|保证，担保
guideline|指导方针，准则
guilty|有罪的，内疚的
halt|停止，暂停
handful|一把；少数
handle|把手；处理
handy|方便的，手边的
harbor|海港，避难所
hardship|艰难，困苦
hardware|硬件，五金
harmony|和谐，融洽
harness|利用，治理
harsh|严厉的，刺耳的
haste|匆忙，急忙
hatred|仇恨，憎恶
haul|拖运，搬运
hazard|危险，危害
heading|标题，信头
heap|堆，大量
heave|举起，投掷
hedge|树篱，障碍物
heel|脚后跟，鞋跟
heir|继承人
hence|因此，从此
herd|兽群，牧群
hesitate|犹豫，迟疑
highlight|突出，强调
hinder|阻碍，妨碍
hint|暗示，线索
hip|臀部，髋骨
historic|有历史意义的
hollow|空的，空心的
holy|神圣的，圣洁的
honorable|光荣的，可敬的
hook|钩子，挂钩
horizon|地平线，视野
horn|号角，喇叭
horrible|可怕的，恐怖的
horror|恐怖，战栗
hostile|敌对的，敌意的
household|家庭的；家务
housing|住房，外壳
humble|谦卑的，简陋的
humor|幽默，诙谐
hunger|饥饿，渴望
hunt|打猎，搜寻
hurl|猛投，用力扔
hut|小屋，棚屋
ideal|理想的，完美的
identical|完全相同的，同一的
identity|身份，特征
idle|懒惰的，闲置的
ignorance|无知，愚昧
illegal|非法的，违法的
illustrate|说明，阐明
image|形象，图像
imaginary|想象中的，虚构的
imitate|模仿，仿效
immense|巨大的，广大的
immigrant|移民，侨民
impact|影响，冲击
impatient|不耐烦的，急躁的
implement|实施，执行
implication|含义，暗示
imply|暗示，意味
import|进口，输入
impose|强加，征税
impress|给...留下印象
impulse|冲动，推动
incident|事件，事变
incline|倾向于，斜坡
inclusive|包含的，包容的
income|收入，所得
incorporate|合并，包含
incredible|难以置信的，极好的
incur|招致，引起
independence|独立，自主
indicate|表明，暗示
indifferent|冷漠的，不感兴趣的
indispensable|必不可少的，必需的
individual|个人的，单独的
indoor|室内的
induce|引诱，引起
industrial|工业的，产业的
inevitable|不可避免的，必然的
infant|婴儿，幼儿
infect|传染，感染
infer|推断，推论
inferior|下等的，较差的
infinite|无限的，无穷的
inflation|通货膨胀
influence|影响，作用
inform|通知，告知
ingredient|成分，原料
inhabit|居住于，栖息于
inherit|继承，遗传
initial|最初的，开头的
initiative|主动性，首创精神
inject|注射，注入
injure|伤害，损害
innocent|无辜的，清白的
input|输入，投入
inquire|询问，调查
insert|插入，嵌入
insight|洞察力，深刻见解
inspect|检查，视察
inspire|鼓舞，激励
install|安装，设置
instance|例子，实例
instant|瞬间，立即的
instinct|本能，直觉
institute|学院，研究所
instruct|指示，命令
instrument|仪器，工具
insult|侮辱，冒犯
insurance|保险，保险费
integrate|使结合，使一体化
integrity|完整，正直
intellectual|智力的，知识分子
intelligent|聪明的，有才智的
intend|打算，想要
intense|强烈的，紧张的
interact|互动，相互作用
interfere|干涉，干扰
interior|内部的，内地的
intermediate|中间的，中级的
internal|内部的，国内的
interpret|口译，解释
interrupt|打断，中断
interval|间隔，间歇
interview|面试，采访
intimate|亲密的，私人的
invade|入侵，侵略
invasion|入侵，侵略
invent|发明，创造
invest|投资，投入
investigate|调查，研究
invisible|看不见的，无形的
invitation|邀请，请柬
involve|涉及，包含
isolate|使孤立，隔离
issue|问题，发行
item|项目，条款
jam|果酱；堵塞
jaw|下巴，颌
jealous|嫉妒的，吃醋的
jet|喷气式飞机；喷射
joint|关节；连接的
journal|日报，日志
jury|陪审团，评委会
justify|证明...是正当的
keen|热切的，敏锐的
kettle|水壶，锅
keyboard|键盘
kidnap|绑架，诱拐
kindergarten|幼儿园
kneel|跪下
knot|结，打结
label|标签，标记
laboratory|实验室，研究室
lack|缺乏，不足
lag|落后，滞后
lamb|羔羊，小羊
landlord|房东，地主
lane|小路，车道
lap|一圈，大腿
largely|主要地，大量地
laser|激光
latter|后者的，后一半的
launch|发射，发起
laundry|洗衣店，待洗衣物
lavatory|厕所，盥洗室
lawn|草坪，草地
layer|层，层次
layout|布局，设计
leadership|领导，领导地位
leak|漏洞，泄漏
lean|倾斜，依靠
leap|跳跃，飞跃
learned|博学的，有学问的
lease|租约，出租
leather|皮革，皮制品
legal|法律的，合法的
legislation|法律，立法
leisure|闲暇，休闲
lens|透镜，镜头
liable|有责任的，有...倾向的
liberal|自由的，慷慨的
liberty|自由，自由权
librarian|图书管理员
licence/license|执照，许可证
lick|舔，舔吃
lid|盖子，盖
lightning|闪电，雷电
likely|可能的，有希望的
likewise|同样地，也
limb|肢，臂
lime|石灰
limitation|限制，局限
link|链接，联系
liquid|液体，液态的
literary|文学的，书面的
liver|肝脏，生活者
loaf|一条面包，游荡
loan|贷款，借出
lobby|大厅，休息室
local|当地的，局部的
locate|位于，坐落于
lodge|暂住，借宿
log|原木，日志
logic|逻辑，逻辑学
loosen|松开，放松
lord|上帝，贵族
lorry|卡车，货车
loyal|忠诚的，忠心的
lump|块，团
lung|肺，肺脏
luxury|奢侈，奢华
machinery|机械，机器（总称）
magic|魔法，魔术
magnet|磁铁，磁体
magnificent|壮丽的，宏伟的
maid|女仆，侍女
mainland|大陆，本土
maintain|维持，保持
maintenance|维护，保养
major|主要的，重大的
male|男性的，雄性的
management|管理，经营
mankind|人类
manual|手册，指南
manufacture|制造，加工
margin|页边空白；利润
marine|海生的，海产的
married|已婚的，婚姻的
marvelous|极好的，非凡的
mask|面具，口罩
massive|巨大的，大规模的
mat|垫子
mate|伙伴，同事
mathematical|数学的
mature|成熟的，到期的
maximum|最大值，最大限度
means|方法，手段
meantime|其间，同时
measurement|测量，尺寸
mechanic|技工，机修工
mechanical|机械的，力学的
mechanism|机制，机械装置
medal|奖章，勋章
media|媒体，媒介
medium|中等的，媒介
melon|瓜，甜瓜
melt|融化，熔化
memorial|纪念物，纪念碑
merchant|商人，生意人
mercy|仁慈，宽恕
mere|仅仅，只不过
merry|愉快的，欢乐的
mess|混乱，脏乱
microphone|麦克风
microscope|显微镜
mild|温和的，轻微的
military|军事的，军用的
mill|工厂，磨坊
millimeter|毫米
mineral|矿物，矿物质
minimum|最小值，最低限度
ministry|（政府的）部
minor|较小的，次要的
minus|减去，负的
miracle|奇迹，奇事
miserable|痛苦的，悲惨的
mislead|误导，将...引入歧途
missing|丢失的，失踪的
mission|使命，任务
mist|薄雾，雾霭
misunderstand|误解，误会
mixture|混合物，混合体
mobile|移动的，易变的
mode|方式，模式
moderate|适度的，中等的
modest|谦虚的，适度的
modify|修改，更改
moist|潮湿的，湿润的
molecule|分子，微粒
monitor|监视器，班长
monument|纪念碑
mood|情绪，心情
moral|道德的，道义的
moreover|而且，此外
mosquito|蚊子
motion|运动，手势
motivate|激发，激励
motive|动机，目的
mount|登上，爬上
movie|电影，影片
mud|泥，泥浆
multiple|多重的，多样的
multiply|乘，繁殖
muscle|肌肉，体力
musical|音乐的，悦耳的
mutual|相互的，共同的
mysterious|神秘的，不可思议的
naked|裸体的，无遮蔽的
namely|即，也就是
nationality|国籍，民族
natural|自然的，正常的
naval|海军的，军舰的
navigation|导航，航行
navy|海军，舰队
nearby|附近的，在附近
neat|整洁的；利索的
necessarily|必要地；必然地
necessity|必需品，必要
negative|消极的；否定的
neglect|忽视，忽略
negotiate|谈判，协商
neighbor(u)rhood|街区，邻近
nerve|神经；勇气
nest|巢，窝
network|网络，网状系统
neutral|中立的，中性的
nevertheless|然而，不过
nightmare|噩梦
noble|高尚的；贵族的
nod|点头
nonsense|胡说，废话
noodle|面条
normally|正常地，通常地
notebook|笔记本
noticeable|显而易见的
notify|通知，告知
notion|概念，想法
noun|名词
novel|小说
nowhere|任何地方都不
nuclear|原子核的；核心的
numerous|众多的，许多的
nursery|托儿所，苗圃
nylon|尼龙，聚酰胺纤维
obey|服从，听从
object|物体；反对
objection|反对，异议
objective|客观的；目标
obligation|义务，责任
oblige|迫使，责成
observation|观察，观测
observe|观察；遵守
obstacle|障碍，障碍物
obtain|获得，得到
obvious|明显的，显而易见的
occasion|场合，时机
occasional|偶尔的，偶然的
occupation|职业，占用
occupy|占据，占领
occur|发生，出现
odd|奇怪的；奇数的
offend|冒犯，得罪
offense|冒犯，罪行
offensive|冒犯的，进攻的
offer|提供；提议
omit|省略，遗漏
onion|洋葱，葱头
opening|开始；空缺
opera|歌剧
operate|操作，运转
operator|操作员，接线员
opponent|对手，敌手
opportunity|机会，时机
oppose|反对，反抗
optical|光的，视力的
optimistic|乐观的，乐观主义的
option|选择，选项
oral|口头的，口述的
orbit|轨道；环绕
orchestra|管弦乐队
orderly|整齐的；有秩序的
ore|矿石，矿砂
organ|器官；风琴
organic|有机的，有机体的
organism|生物体，有机体
organization|组织，机构
origin|起源，出身
original|最初的；原创的
ornament|装饰，装饰品
ounce|盎司，少量
outcome|结果，后果
outdoor|户外的，露天的
outer|外部的，外面的
outlet|出口，插座
outline|大纲，轮廓
outlook|展望，观点
output|产量，输出
outset|开始，开端
outstanding|杰出的，突出的
outward|向外的，外出的
oval|椭圆形的
oven|烤箱，烤炉
overall|总体的；全部的
overcome|克服，战胜
overhead|头顶上的；管理费用
overlook|俯瞰；忽视
overnight|通宵的；突然的
overseas|海外的，在海外
overtake|追上，超过
owe|欠；归功于
owner|主人，物主
ownership|所有权，物主身份
oxygen|氧气，氧
pace|步速，速度
package|包裹，包
pad|垫；便笺本
painter|画家，油漆工
palm|手掌，棕榈树
panel|面，板
panic|恐慌，惊慌
pants|裤子
parade|游行，检阅
paragraph|段落，节
parallel|平行的；类似的
parcel|包裹，邮包
parliament|议会，国会
partial|部分的，偏爱的
participate|参与，参加
particle|微粒，颗粒
particularly|特别地
partner|伙伴，合伙人
passion|激情，热情
passive|被动的，消极的
passport|护照
paste|浆糊；粘贴
pat|轻拍
patch|补丁，斑
patience|耐心，忍耐
paw|爪子
payment|支付，付款额
pea|豌豆
peach|桃子
peak|山顶，顶点
peanut|花生
pear|梨子，梨树
peculiar|奇怪的，特殊的
peer|同龄人；凝视
penalty|处罚，罚款
pension|养老金，抚恤金
pepper|胡椒粉，辣椒
per|每，每一
perceive|察觉，感知
percentage|百分比，百分率
perception|感知，认识
perform|表演，执行
perfume|香水，香味
period|时期，一段时间
permanent|永久的，永恒的
permission|许可，允许
persist|坚持，持续
personality|个性，人格
personnel|人事，全体人员
perspective|视角，远景
persuade|说服，劝说
pessimistic|悲观的，悲观主义的
petrol|汽油
petroleum|石油
phase|阶段，相位
phenomenon|现象，奇迹
philosopher|哲学家，思想家
philosophy|哲学，人生观
phone|电话，电话机
phrase|短语，词组
physical|身体的；物理的
physician|内科医生
physicist|物理学家
piano|钢琴
pick|挑选，采摘
picnic|野餐，郊游
pie|馅饼，派
pierce|刺穿，穿透
pigeon|鸽子
pill|药丸，药片
pillar|柱子，支柱
pillow|枕头
pilot|飞行员，领航员
pin|别针，大头针
pinch|捏，掐
pine|松树
pint|品脱（容量单位）
pit|深坑，矿井
pitch|场地；音高
planet|行星
plantation|种植园
plastic|塑料的；可塑的
platform|平台；站台
pledge|保证，誓言
plentiful|丰富的，充足的
plot|情节；小块土地
plug|插头；插座
plunge|投入；使突然下降
plural|复数的；复数
plus|加；正的
poem|诗，韵文
poet|诗人
poetry|诗歌，诗作
poison|毒药；毒害
poisonous|有毒的，恶毒的
policy|政策，方针
polish|磨光，擦亮
politician|政治家
poll|投票，民意测验
pollute|污染，弄脏
pond|池塘
pop|流行音乐；爆裂声
portable|手提的，便携的
porter|搬运工，门房
portion|部分，一份
portrait|肖像，画像
pose|姿势，摆姿势
positive|积极的；肯定的
possess|拥有，占有
possibility|可能性，可能
postage|邮资，邮费
poster|海报，招贴画
postpone|推迟，延期
potential|潜在的；潜力
pound|磅；英镑
pour|倒，灌
poverty|贫穷，贫困
powder|粉末，粉
powerful|强有力的，强大的
practically|几乎，实际上
pray|祈祷，恳求
precaution|预防措施
preceding|在前的，在先的
precise|精确的，准确的
predict|预言，预测
preface|序言，前言
prefer|更喜欢，宁愿
preference|偏爱，优先权
pregnant|怀孕的，孕育的
prejudice|偏见，成见
preliminary|初步的，预备的
preparation|准备，预备
preposition|介词
prescribe|开（药），规定
presence|出席，存在
presentation|展示，陈述
preserve|保护，保存
pressure|压力，压迫
pretend|假装，装作
prevail|流行，占优势
prevent|阻止，妨碍
previous|以前的，先前的
priest|牧师，神父
primary|主要的，初级的
prime|主要的，首要的
primitive|原始的，简单的
principal|校长；主要的
principle|原则，原理
prior|优先的，在前的
priority|优先权，重点
private|私人的，私有的
privilege|特权，优待
probable|可能的，大概的
procedure|程序，步骤
proceed|继续进行，开始
process|过程；加工
product|产品，产物
profession|职业，专业
professional|专业的，职业的
profile|侧面，轮廓
profit|利润，收益
progressive|进步的，先进的
prohibit|禁止，阻止
project|项目，工程
prominent|杰出的，突出的
promote|促进，提升
prompt|提示；迅速的
proof|证据，证明
property|财产，资产
proportion|比例，份额
proposal|提议，建议
propose|提议，建议
prospect|前景，前途
prosperity|繁荣，兴旺
protective|保护的，防护的
protein|蛋白质
protest|抗议，反对
provided|假如，倘若
province|省，省份
provision|提供，条款
provoke|挑衅，激起
psychological|心理的，心理学的
publication|出版，出版物
publicity|公众的注意，宣传
publish|出版，发行
pulse|脉搏；脉冲
pump|泵；打气
punch|拳打；打孔
punctual|守时的，准时的
purchase|购买，购置
purple|紫色的，紫红色的
purse|钱包，女用小包
pursue|追求，致力于
puzzle|谜；使困惑
qualification|资格，条件
qualify|使具有资格
queue|队列，排队
quit|停止，放弃
quiz|测验，小考
quotation|引文，报价
quote|引用，引述
rabbit|兔子，野兔
racial|种族的，人种的
rack|架子，挂架
radar|雷达
radiation|辐射，放射线
radical|激进的，根本的
rag|破布，碎布
rage|愤怒，狂怒
raid|袭击，搜捕
rail|栏杆，铁轨
railroad|铁路，铁道
rainbow|彩虹
rainy|下雨的，多雨的
rally|集会；恢复（健康）
range|范围；一系列
rank|等级，军衔
rare|罕见的，稀有的
rarely|很少，不常
rat|老鼠，耗子
rate|比率，速度
ratio|比，比率
rational|理性的，合理的
raw|生的；未加工的
ray|光线，射线
react|反应，起作用
reader|读者；读物
readily|乐意地；容易地
reading|阅读，读书
realistic|现实的，实际的
reality|现实，实际
realm|领域，王国
rear|后面的； rear 部
reasonable|合理的，公道的
rebel|反叛，反抗
recall|回忆，召回
receipt|收据，收条
receiver|接收者，听筒
recent|最近的，近来的
reception|接待，接收
recession|衰退，不景气
reckon|认为，估计
recognition|认出，承认
recommend|推荐，建议
reconcile|使和解，调停
recorder|录音机，记录员
recovery|恢复，痊愈
recreation|娱乐，消遣
recruit|招募，招聘
reduction|减少，降低
reference|参考，参照
refine|精炼，提纯
reflect|反映，反射
reform|改革，改良
refresh|使恢复精神
refrigerator|冰箱，冷藏库
refuge|避难，庇护
refusal|拒绝
regarding|关于
regardless|不管，不顾
region|地区，区域
register|登记，注册
regulate|管理，调节
reinforce|加强，加固
reject|拒绝，排斥
relate|联系，叙述
relationship|关系，联系
relativity|相对论，相关性
relax|放松，休息
release|释放，发布
relevant|相关的，切题的
reliable|可靠的，可信赖的
relief|减轻，救济
religion|宗教，信仰
religious|宗教的，虔诚的
reluctant|不情愿的，勉强的
rely|依靠，依赖
remark|评论，谈论
remarkable|非凡的，值得注意的
remedy|治疗法，补救
remote|遥远的，偏僻的
render|使得，给予
renew|更新，续借
rent|租用，出租
repeatedly|反复地，再三地
repetition|重复，反复
replace|代替，替换
represent|代表，象征
representative|代表，代理人
reproduce|复制，繁殖
republic|共和国，共和政体
reputation|名誉，声望
requirement|要求，必要条件
rescue|营救，救援
resemble|像，类似于
reservation|预订，保留
reserve|储备；保留
residence|居住，住所
resident|居民，定居的
resign|辞职，放弃
resist|抵抗，抵制
resistance|抵抗，阻力
resolution|决心，决定
resolve|解决，决心
resort|求助，诉诸；度假胜地
resource|资源，财力
respectively|分别地，各自地
respond|回答，响应
response|回答，响应
responsibility|责任，职责
responsible|负责的，可靠的
restless|焦躁不安的，不平静的
restore|恢复，修复
restrain|抑制，控制
restraint|抑制，克制
restrict|限制，约束
resume|简历；重新开始
retail|零售
retain|保留，保持
retire|退休，离开
retreat|撤退，退却
reveal|揭示，揭露
revenue|收入，税收
reverse|颠倒，反转
revise|修订，修改
revive|使复兴，苏醒
revolt|反叛，反抗
revolution|革命，巨变
reward|奖励，报酬
rhythm|节奏，韵律
rib|肋骨
ribbon|丝带，缎带
ridiculous|可笑的，荒谬的
rifle|步枪
rigid|严格的，僵硬的
riot|暴乱，骚乱
risk|风险，危险
rival|竞争对手，对手
roar|咆哮，吼叫
roast|烤，烘烤
rob|抢劫，盗窃
robot|机器人
rocket|火箭
rod|杆，棒
roller|滚筒，滚轴
romantic|浪漫的
rope|绳子，绳索
rotate|旋转，轮流
rouse|唤醒，激起
route|路线，路程
routine|例行公事，常规
royal|皇家的，王室的
rub|擦，摩擦
rude|粗鲁的，无礼的
rug|小地毯，毛毯
rumor|谣言，传闻
rural|农村的，乡村的
rust|锈，生锈
sack|袋子，解雇
sacrifice|牺牲，奉献
saddle|马鞍
sailor|水手，海员
saint|圣人，圣徒
sake|缘故，理由
salad|沙拉，凉拌菜
salary|薪水，薪金
salesman|售货员，推销员
sample|样品，样本
sanction|批准，制裁
satellite|卫星
satisfactory|令人满意的
saucer|茶碟，浅盘
sausage|香肠，腊肠
saving|储蓄，存款
saw|锯，锯开
scale|规模；比例尺
scan|扫描；浏览
scandal|丑闻
scarce|稀有的，罕见的
scare|惊吓，害怕
scatter|分散，撒
scenery|风景，布景
schedule|时间表，计划表
scheme|方案，计划
scholar|学者
scholarship|奖学金；学问
scissors|剪刀
scope|范围，机会
scout|侦察，童子军
scrape|刮，擦
scratch|抓，搔
screen|屏幕，银幕
screw|螺丝，旋钮
script|剧本，手稿
seal|海豹；封条
secondary|次要的，中级的
section|部分，部门
secure|安全的，可靠的
security|安全，保障
segment|部分，片段
select|选择，挑选
selection|选择，挑选
selfish|自私的
semester|学期
semiconductor|半导体
seminar|研讨会，研讨班
senate|参议院，大学理事会
senator|参议员
senior|年长的，高级的
sensible|明智的，理智的
sensitive|敏感的，灵敏的
sequence|序列，顺序
series|系列，连续剧
session|会议，学期
setting|环境，背景
settlement|定居点，解决
severe|严重的，严厉的
sexual|性的，性别的
shallow|浅的，肤浅的
shave|刮，剃
shed|流出；棚屋
sheer|纯粹的，陡峭的
shell|壳，炮弹
shelter|庇护所，避难所
shield|盾牌，保护
shift|移动，轮班
shiver|颤抖，发抖
shortage|短缺，不足
shortcoming|缺点，短处
shrink|收缩，缩小
shrug|耸肩
sideways|向侧面地
sigh|叹息，叹气
sightseeing|观光，游览
signal|信号，暗号
signature|签名，署名
significance|意义，重要性
significant|重要的，有意义的
simplicity|简单，朴素
simplify|简化，使简易
sin|罪，罪恶
sincere|真诚的，诚挚的
singular|单数的；非凡的
site|地点，场所
skate|滑冰，溜冰
skeleton|骨架，骨骼
sketch|素描，草图
ski|滑雪，滑雪板
skilled|熟练的，有技能的
skillful|灵巧的，熟练的
skim|掠过，浏览
slam|砰地关上
slap|掌掴，拍打
sleeve|袖子
slender|苗条的，纤细的
slice|薄片，切片
slide|滑动，滑梯
slight|轻微的，纤细的
slim|苗条的，修长的
slip|滑倒，滑落
slippery|滑的，狡猾的
slit|切开，裂缝
slope|斜坡，倾斜
smash|打碎，撞击
snap|折断，猛咬
soak|浸泡，浸湿
soar|高飞，剧增
sob|抽泣，哭泣
so-called|所谓的
soccer|英式足球
social|社会的，社交的
soda|苏打水，汽水
sofa|沙发
software|软件
solar|太阳的，太阳能的
sole|脚底；唯一的
solemn|庄严的，隆重的
solution|解决方案，溶液
solve|解决，解答
somehow|不知怎么地
somewhat|稍微，有点
sophisticated|复杂的，老练的
sore|疼痛的，酸痛的
sorrow|悲伤，悲痛
sour|酸的，发酵的
source|来源，出处
southeast|东南
southwest|西南
sow|播种，散布
spacecraft|宇宙飞船
spade|铲子，铁锹
span|跨度，范围
spark|火花，引发
speaker|演讲者，扬声器
specialist|专家
specialize|专门从事
species|物种，种类
specific|具体的，明确的
specify|指定，详细说明
specimen|标本，样本
spectacular|壮观的，惊人的
speculate|推测，投机
spelling|拼写，拼法
sphere|球体，范围
spider|蜘蛛
spill|溢出，洒落
spin|旋转， spinning
spiritual|精神的，心灵的
spit|吐痰，吐口水
spite|恶意，怨恨
split|分裂，分开
spoil|宠坏；变质
spokesman|发言人
sponsor|赞助者，主办者
spoon|勺子，匙
sportsman|运动员
spot|地点，斑点
spray|喷雾，喷洒
spur|刺激，激励
squeeze|挤压，榨取
stable|稳定的，牢固的
stack|堆，垛
stadium|体育场
staff|全体职员， staff
stain|污点，染色
stake|桩，赌注
stale|不新鲜的，陈腐的
standpoint|立场，观点
starve|挨饿，饿死
statement|声明，陈述
statesman|政治家
static|静态的，静止的
statistic|统计数值
statue|雕像，塑像
status|地位，状态
steady|稳定的，稳固的
steak|牛排，肉排
steamer|汽船，蒸锅
steep|陡峭的，险峻的
steer|驾驶，引导
stem|茎，干
stereotype|刻板印象
sticky|粘的，粘性的
stiff|僵硬的；艰难的
stimulate|刺激，激励
sting|刺，叮
stir|搅拌，搅动
stock|库存，股票
stocking|长筒袜
stoop|弯腰，俯身
storage|存储，仓库
stove|炉子，火炉
strain|拉紧； strain
strap|带子，皮带
strategy|策略，战略
straw|稻草，吸管
strawberry|草莓
stream|小溪，流
strengthen|加强，增强
stress|压力，强调
stretch|伸展，延伸
striking|显著的，惊人的
string|线，字符串
strip| strips；剥去
stripe|条纹，斑纹
stroke|一击；中风
structure|结构，构造
studio|工作室，画室
stuff|东西，物品
style|风格，样式
submerge|淹没，潜入水中
submit|提交，屈服
subsequent|随后的，后来的
substance|物质，实质
substantial|大量的，坚固的
substitute|代替者，代替品
subtract|减去，扣除
suburb|郊区，城郊
subway|地铁
succession|连续，继任
successive|连续的，接连的
suck|吸，吮吸
sufficient|足够的，充足的
suggestion|建议，提议
suicide|自杀
suitable|合适的，适宜的
suite|套房，套件
sum|总数，金额
summarize|总结，概述
summary|总结，摘要
summit|顶峰，峰会
sunlight|阳光，日光
sunrise|日出，黎明
sunset|日落，傍晚
super|超级的，极好的
superb|极好的，卓越的
superficial|表面的，肤浅的
superior|上级的；优越的
supermarket|超市，超级市场
supplement|增补，补充
suppose|假设，认为
supreme|最高的，至上的
surge|汹涌，激增
surgeon|外科医生
surgery|外科，手术
surplus|过剩，盈余
surrender|投降，放弃
surround|包围，环绕
surroundings|环境，周围事物
survey|调查，测量
survival|幸存，生存
suspect|怀疑，嫌疑犯
suspend|暂停，悬架
suspicion|怀疑，猜疑
sustain|维持，支撑
swallow|燕子；吞下
sway|摇摆，影响
swear|发誓，咒骂
sweat|汗水，出汗
sweater|毛衣，运动衫
swell|肿胀，膨胀
swift|迅速的，敏捷的
swing|摇摆，秋千
switch|开关，转换
sword|剑，刀
symbol|符号，象征
sympathetic|同情的，有同情心的
sympathy|同情，同情心
symptom|症状，征兆
synthetic|合成的，人造的
system|系统，体系
tackle|处理，对付
tag|标签，标记
talent|天赋，才能
tame|驯服的，驯养
tan|棕褐色，晒黑
tank|坦克；水槽
tap|水龙头；轻拍
target|目标，靶子
tax|税，税收
tease|戏弄，取笑
technical|技术的，工艺的
technician|技术员，技师
technique|技术，方法
tedious|冗长乏味的，沉闷的
teenager|青少年，十几岁的孩子
telescope|望远镜
temper|脾气，情绪
temple|寺庙，神殿
temporary|暂时的，临时的
tempt|引诱，诱惑
temptation|诱惑，引诱
tend|趋向，倾向
tendency|趋势，倾向
tender|温柔的；嫩的
tense|紧张的；时态
tension|紧张，张力
terminal|末端的，终点站
territory|领土，版图
terror|恐怖，恐惧
textile|纺织品
theme|主题，题目
theoretical|理论的，假设的
theory|理论，学说
therapy|治疗，疗法
thereby|因此，从而
thermometer|温度计，体温计
thirst|渴，口渴
thorn|刺，荆棘
thorough|彻底的，完全的
thoughtful|体贴的，深思的
threat|威胁，恐吓
threaten|威胁，恐吓
thrill|激动，兴奋
throat|喉咙，咽喉
thrust|推力；刺
thumb|拇指
thunder|雷，雷声
tide|潮汐，潮流
tidy|整洁的，整齐的
timber|木材，木料
tissue|组织，薄纸
title|标题，头衔
toast|烤面包；干杯
toe|脚趾，足尖
token|代币；象征
tolerate|容忍，忍受
tone|语气，音调
topic|话题，主题
torch|手电筒，火炬
torture|折磨，拷问
tough|艰难的；强硬的
tour|旅游，旅行
towel|毛巾，手巾
trace|痕迹，踪迹
tractor|拖拉机
tradition|传统，惯例
tragedy|悲剧，惨案
trail|小径，踪迹
transfer|转移，调动
transform|转换，变形
transformation|转换，变形
transistor|晶体管
transmission|传输，传播
transmit|传输，发射
transparent|透明的，明显的
transport|运输，运送
trap|陷阱，圈套
trash|垃圾，废物
tray|托盘，碟子
treatment|治疗，待遇
treaty|条约，协议
tremble|颤抖，发抖
tremendous|巨大的，惊人的
trend|趋势，倾向
trial|审判，试验
triangle|三角形，三角形物体
trim|修剪，整理
triumph|胜利，成功
troop|部队，一群
tropical|热带的
troublesome|麻烦的，讨厌的
trumpet|小号，喇叭
trunk|树干；行李箱
tube|管子，地铁（英）
tune|曲调， tune
tunnel|隧道，地道
turbine|涡轮机
tutor|导师，家庭教师
twist|扭曲，拧
typewriter|打字机
typical|典型的，有代表性的
typist|打字员
ultimate|最终的，极致的
umbrella|雨伞
uncover|揭开，揭露
undergo|经历，经受
underline|在...下面划线
underneath|在...下面，底部
understanding|理解，谅解
undertake|承担，着手做
undo|解开，取消
undoubtedly|无疑地，必定地
uneasy|不安的，担心的
unexpected|意外的，未料到的
unfair|不公平的
unfortunately|不幸地，遗憾地
union|联盟，工会
unique|独特的，唯一的
unity|团结，统一
universal|普遍的，通用的
universe|宇宙
unlike|不像，和...不同
unlikely|不太可能的
unload|卸货，卸载
unusual|不寻常的，独特的
upper|上面的，上部的
upright|垂直的，正直的
upset|心烦的；打翻
up-to-date|最新的，现代的
urban|城市的，都市的
urge|催促，强烈欲望
urgent|紧急的，急迫的
usage|使用，用法
utility|效用，公用事业
utilize|利用，使用
utmost|极度的，最大限度的
utter|完全的；说出
vacant|空的，空缺的
vacuum|真空，吸尘器
vague|模糊的，不明确的
vain|徒劳的，虚荣的
valid|有效的，合理的
van|厢式货车，面包车
vanish|消失，突然不见
vapor|蒸汽，水汽
variable|可变的，变量
variation|变化，变体
variety|多样性，种类
vary|变化，不同
vast|巨大的，广阔的
vehicle|车辆，交通工具
veil|面纱，遮盖
venture|冒险，风险项目
verb|动词
verify|核实，证明
version|版本，说法
vertical|垂直的，竖的
vessel|船，容器
veteran|老兵，老手
via|经由，通过
vibrate|振动，摇摆
vice|恶习，副的
victim|受害者
video|视频，录像
view|看法，景色
viewpoint|观点，看法
vigorous|精力充沛的，有力的
vinegar|醋
violate|违反，侵犯
violence|暴力
violent|暴力的，猛烈的
violet|紫罗兰，紫色的
violin|小提琴
virtual|虚拟的，实质上的
virtue|美德，优点
virus|病毒
visible|可见的
vision|视力，视野
visual|视觉的
vital|至关重要的
vitamin|维生素
vivid|生动的，鲜明的
vocabulary|词汇，词汇量
volcano|火山
volleyball|排球
volt|伏特
voltage|电压
volume|体积，音量
voluntary|自愿的，志愿的
volunteer|志愿者，自愿者
vote|投票，选举
wagon|四轮马车，货车
waist|腰部，腰
waken|唤醒，醒来
wander|漫步，闲逛
ward|病房， ward
warehouse|仓库，货栈
warfare|战争，冲突
warmth|温暖，热情
waterproof|防水的
wax|蜡，蜂蜡
weaken|削弱，变弱
wealthy|富有的
weapon|武器
weave|编织，组合
weed|杂草，除草
weekday|工作日
weekly|每周的
weep|哭泣，流泪
weld|焊接
welfare|福利，幸福
whale|鲸鱼
whatsoever|无论什么
whereas|然而，尽管
whichever|无论哪个
whip|鞭子，抽打
whisper|低语，耳语
whistle|口哨，汽笛
whoever|无论谁
wholly|完全地，全部地
wicked|邪恶的，淘气的
widen|加宽，变宽
widespread|分布广的，普遍的
widow|寡妇
width|宽度，广度
wisdom|智慧，明智
wit|才智，机智
withdraw|撤退，收回
withstand|经受，承受
witness|目击者，证人
wolf|狼
wool|羊毛
workman|工人，工匠
workshop|车间，研讨会
worldwide|全世界的
worm|蠕虫
worship|崇拜，敬奉
worthless|无价值的，无用的
worthwhile|值得的
worthy|值得的，有价值的
wrap|包裹，包起来
wreck|失事，残骸
wrist|手腕
writer|作家，作者
writing|写作，笔迹
X-ray|X光，X射线
yard|院子，码（长度单位）
yawn|打哈欠
yearly|每年的，一年一度的
yell|叫喊，大叫
yield|屈服，出产
youngster|年轻人，少年
zone|区域，地带