abandon|放弃，抛弃
ability|能力，才能
able|能够的，有能力的
about|关于，大约
above|在...上面
abroad|在国外
absence|缺席，不在场
absent|缺席的，不在的
absolute|绝对的，完全的
absorb|吸收；吸引
abuse|滥用；虐待
academic|学术的
accent|口音，重音
accept|接受
access|接近，通道
accident|事故
accommodation|住宿，调节
accompany|陪伴，伴奏
accomplish|完成，实现
according|根据，按照
account|账户，描述
accurate|准确的，精确的
accuse|指责，控告
achieve|实现，获得
achievement|成就，成绩
acid|酸性的；酸
acknowledge|承认；感谢
acquire|获得，取得
across|穿过，横过
act|行动，表演
action|行动，作用
active|积极的，活跃的
activity|活动，活跃
actor|演员
actress|女演员
actual|实际的，真实的
adapt|适应，改编
add|增加，添加
addition|增加，加法
additional|额外的，附加的
address|地址；演说
adequate|足够的，适当的
adjust|调整，调节
administration|管理，行政部门
admire|钦佩，羡慕
admit|承认；准许进入
adopt|采纳，收养
adult|成年人
advance|前进，进展
advanced|先进的，高级的
advantage|优点，优势
adventure|冒险，奇遇
advertise|做广告，宣传
advertisement|广告
advice|建议，忠告
advise|建议，劝告
advocate|提倡，拥护
affair|事件，事情
affect|影响
afford|负担得起
afraid|害怕的，担心的
after|在...之后
afternoon|下午，午后
again|再一次，又
against|反对；靠着
age|年龄；时代
agency|代理处，机构
agenda|议程表，日程
ago|以前，...前
agree|同意，赞成
agreement|协议，一致
agriculture|农业，农学
ahead|在前面，向前
aid|帮助，援助
aim|目标；瞄准
air|空气；天空
aircraft|飞机，航空器
airline|航空公司；航线
airport|机场
alarm|警报；惊慌
alcohol|酒精，酒
alive|活着的，存在的
all|全部的；所有的
allow|允许，准许
almost|几乎，差不多
alone|独自的；孤独的
along|沿着；向前
aloud|大声地
already|已经，早已
also|也，而且
alter|改变，更改
alternative|可供选择的
although|虽然，尽管
altogether|总共；完全地
always|总是，一直
amazing|令人惊异的
ambition|野心，雄心
ambulance|救护车
among|在...之中
amount|数量；总额
ample|足够的，宽敞的
amuse|娱乐，逗乐
analyze|分析，解析
analysis|分析，分解
ancient|古代的，古老的
and|和，又
anger|愤怒，气愤
angle|角度，角落
angry|生气的，愤怒的
animal|动物
anniversary|周年纪念日
announce|宣布，宣告
annoy|使烦恼，打扰
annual|每年的，年度的
another|另一个；别的
answer|回答，答案
anxiety|焦虑，忧虑
anxious|焦虑的，担心的
any|任何的，一些
anybody|任何人
anyhow|无论如何
anyone|任何人
anything|任何事
anyway|无论如何
anywhere|任何地方
apart|相隔；分开
apartment|公寓，房间
apologize|道歉
apparent|显然的，表面上的
appeal|呼吁；上诉
appear|出现，似乎
appearance|出现，外貌
appetite|胃口，欲望
applaud|鼓掌；称赞
apple|苹果
application|申请；应用
apply|申请；应用
appoint|任命，约定
appointment|约会，任命
appreciate|欣赏；感激
approach|方法；靠近
appropriate|适当的，恰当的
approve|批准，赞成
approximately|大约，近似地
area|地区，区域
argue|争论，辩论
argument|争论，论据
arise|出现；升起
arithmetic|算术
arm|手臂；武器
army|军队，陆军
around|在...周围
arrange|安排，整理
arrest|逮捕，拘留
arrival|到达，到来
arrive|到达，抵达
arrow|箭，箭头
art|艺术，美术
article|文章；物品
artificial|人造的，假的
artist|艺术家，画家
as|作为；当...时
ash|灰，灰烬
ashamed|惭愧的，羞耻的
ashore|在岸上
aside|在旁边
ask|问，询问
asleep|睡着的，睡熟的
aspect|方面，面貌
assess|评估，评价
assign|分配，指派
assist|帮助，协助
assistance|帮助，援助
assistant|助手，助理
associate|联系；伙伴
association|协会，联系
assume|假定，承担
assumption|假定，设想
assure|保证，确保
astonish|使惊讶
astronaut|宇航员
at|在...地点
athlete|运动员
atmosphere|大气；气氛
attach|附上，系上
attack|攻击，抨击
attain|获得，达到
attempt|尝试，企图
attend|出席，参加
attention|注意，关注
attitude|态度，看法
attract|吸引，引起
attraction|吸引力，景点
attractive|有吸引力的
audience|观众，听众
August|八月
aunt|姨母，姑母
authentic|真实的，可靠的
author|作者，作家
authority|权威；当局
automatic|自动的
autumn|秋天，秋季
available|可获得的，有空的
avenue|林荫道，大街
average|平均的；平均水平
avoid|避免，避开
awake|醒着的；唤醒
award|奖品，奖金
aware|知道的，意识到的
away|离开，远离
awful|糟糕的，可怕的
baby|婴儿，宝贝
back|后面的；背部
background|背景，经历
backward|向后的，倒退的
bacon|培根，咸肉
bad|坏的，糟糕的
badly|严重地；恶劣地
bag|包，袋子
baggage|行李
bake|烤，烘焙
balance|平衡；结余
ball|球，舞会
balloon|气球
banana|香蕉
band|乐队；带子
bank|银行；河岸
bar|酒吧；条，棒
barbecue|烤肉野餐
barber|理发师
bare|赤裸的；光秃秃的
bargain|便宜货；交易
bark|狗叫；树皮
barrier|障碍，屏障
base|基础，基地
baseball|棒球
basic|基本的，基础的
basin|盆，水池
basis|基础，根据
basket|篮子
basketball|篮球
bat|蝙蝠；球棒
bath|洗澡；浴缸
bathe|洗澡，游泳
bathroom|浴室，洗手间
battery|电池
battle|战斗，战役
bay|海湾；咆哮
be|是，成为
beach|海滩，沙滩
bean|豆，豆子
bear|熊；忍受
beard|胡须
beat|打，敲；节拍
beautiful|美丽的，漂亮的
beauty|美，美人
because|因为
become|成为，变得
bed|床
bedroom|卧室
bee|蜜蜂
beef|牛肉
beer|啤酒
before|在...之前
begin|开始
beginner|初学者
beginning|开始，开端
behave|表现，举止
behavior|行为，举止
behind|在...后面
being|存在；生物
belief|信念，信仰
believe|相信，认为
bell|钟，铃
belong|属于
below|在...下面
belt|腰带，传送带
bench|长凳，长椅
bend|弯曲，屈身
beneath|在...下方
benefit|利益，好处
beside|在...旁边
besides|此外，而且
best|最好的
bet|打赌；确信
better|更好的
between|在...之间
beyond|在...那边；超出
bicycle|自行车
bid|出价；命令
big|大的，巨大的
bike|自行车
bill|账单；钞票
billion|十亿
biology|生物学
bird|鸟
birth|出生，诞生
birthday|生日
biscuit|饼干
bit|一点，少量
bite|咬，叮
bitter|苦的，痛苦的
black|黑色的；黑人的
blackboard|黑板
blame|责备，责怪
blank|空白的；茫然的
blanket|毯子
bleed|流血，出血
blend|混合，融合
blind|盲的，盲目的
block|大块；街区
blood|血，血液
bloom|开花；繁荣
blow|吹，刮风
blue|蓝色的；忧郁的
board|板；委员会
boast|自夸，吹嘘
boat|船，小船
body|身体，主体
boil|沸腾，煮
bomb|炸弹；投弹
bone|骨头，骨质
book|书，书籍
boot|靴子
border|边界；边缘
bore|使厌烦；钻孔
bored|感到厌烦的
boring|令人厌烦的
born|天生的，出生的
borrow|借，借用
boss|老板，上司
both|两者，双方
bother|打扰，麻烦
bottle|瓶子
bottom|底部，基部
bounce|弹起，反弹
bound|一定的；有义务的
boundary|边界，分界线
bow|鞠躬；船头
bowl|碗，钵
box|盒子，箱子
boxing|拳击
boy|男孩，少年
brain|大脑，智力
branch|树枝；分部
brave|勇敢的，无畏的
bread|面包
break|打破；休息
breakfast|早餐
breath|呼吸，气息
breathe|呼吸
brick|砖，砖块
bride|新娘
bridge|桥，桥梁
brief|简短的，简洁的
bright|明亮的；聪明的
brilliant|杰出的，辉煌的
bring|带来，拿来
broad|宽的，广阔的
broadcast|广播，播放
brochure|小册子
broken|破碎的，坏掉的
broom|扫帚
brother|兄弟
brown|棕色的；褐色的
brush|刷子；刷
budget|预算
build|建造，建设
building|建筑物，楼房
bunch|束，串
burden|负担，重担
bureau|局，办事处
burn|燃烧；烧伤
burst|爆裂，爆炸
bury|埋葬，掩埋
bus|公共汽车
bush|灌木，灌木丛
business|商业，生意
businessman|商人
busy|忙的，繁忙的
but|但是，除了
butter|黄油
button|按钮；纽扣
buy|买，购买
by|通过；在...旁边
cab|出租车，计程车
cabbage|卷心菜
cafe|咖啡馆，小餐馆
cage|笼子，鸟笼
calculate|计算，核算
call|打电话；称呼
calm|平静的；冷静的
camel|骆驼
camera|照相机，摄像机
camp|营地；扎营
campaign|运动，战役
can|能，可以；罐头
Canada|加拿大
canal|运河，水道
cancel|取消，撤销
cancer|癌症
candidate|候选人，报考者
candle|蜡烛
candy|糖果
cap|帽子，便帽
capable|有能力的，能干的
capacity|容量；能力
capital|首都；资本
captain|队长，船长
capture|捕获，占领
car|汽车，轿车
carbon|碳
card|卡片，纸牌
care|关心；照顾
career|职业，事业
careful|小心的，仔细的
careless|粗心的，漫不经心的
cargo|货物，船货
carpenter|木匠
carpet|地毯
carriage|四轮马车；客车厢
carrier|搬运工；载体
carrot|胡萝卜
carry|携带，运送
cart|二轮马车；购物车
case|情况，案例
cash|现金，现款
cassette|磁带
cast|投掷；铸造
castle|城堡
casual|随意的，非正式的
cat|猫
catalog|目录
catch|抓住；赶上
category|类别，种类
cattle|牛，家畜
cause|原因；引起
caution|小心，谨慎
cautious|小心的，谨慎的
cave|山洞，洞穴
cease|停止，终止
ceiling|天花板
celebrate|庆祝，祝贺
cell|细胞；小房间
cent|分，分币
center|中心，中央
central|中心的，主要的
century|世纪，百年
ceremony|典礼，仪式
certain|确定的，无疑的
certainly|当然，无疑
certificate|证书，证明书
chain|链子；连锁店
chair|椅子；主席
chairman|主席，董事长
challenge|挑战，难题
champion|冠军，拥护者
chance|机会，可能性
change|改变；零钱
channel|频道；渠道
chapter|章，回
character|性格；角色
characteristic|特征，特点
charge|收费；指控
chart|图表，曲线图
chase|追逐，追求
chat|聊天，闲谈
cheap|便宜的，廉价的
cheat|欺骗，作弊
check|检查；支票
cheek|面颊，脸蛋
cheer|欢呼，喝彩
cheese|奶酪，干酪
chef|厨师，主厨
chemical|化学的；化学品
chemist|药剂师，化学家
chemistry|化学
cheque|支票
chess|国际象棋
chest|胸腔，箱子
chicken|鸡肉；小鸡
chief|主要的；首领
child|孩子，儿童
childhood|童年，幼年
chocolate|巧克力
choice|选择，抉择
choose|选择，挑选
chopsticks|筷子
Christian|基督徒；信奉基督教的
Christmas|圣诞节
church|教堂；礼拜
cigarette|香烟
cinema|电影院
circle|圆圈；圈子
circumstance|情况，环境
citizen|公民，市民
city|城市，都市
civil|公民的；国内的
civilian|平民，百姓
claim|声称；索赔
class|班级；等级
classic|经典的，古典的
classmate|同学，同班同学
classroom|教室
clean|干净的；清洁
clear|清晰的；清楚的
clerk|职员，办事员
clever|聪明的，机灵的
click|点击；发出咔哒声
climate|气候，风气
climb|爬，攀登
clinic|诊所，门诊部
clock|时钟，钟表
close|亲密的；关闭
cloth|布，织物
clothes|衣服，服装
clothing|衣服，衣着
cloud|云，云朵
cloudy|多云的，阴天的
club|俱乐部，社团
clue|线索，提示
clumsy|笨拙的，笨手笨脚的
coach|教练；长途汽车
coal|煤，煤块
coast|海岸，海滨
coat|外套，上衣
cock|公鸡；龙头
code|代码，密码
coffee|咖啡
coin|硬币；创造
cold|冷的；感冒
collar|衣领，领子
colleague|同事，同僚
collect|收集，采集
collection|收藏品，收集
college|学院，大学
collision|碰撞，冲突
color|颜色
column|列，专栏
comb|梳子；梳理
combination|结合，组合
combine|结合，联合
come|来，来到
comedy|喜剧，喜剧片
comfort|舒适；安慰
comfortable|舒适的，舒服的
command|命令；掌握
comment|评论，意见
commerce|商业，贸易
commercial|商业的，商务的
commission|委员会；佣金
commit|犯（罪）；承诺
commitment|承诺，保证
committee|委员会
common|普通的，常见的
communicate|交流，沟通
communication|交流，通讯
community|社区，社会
companion|同伴，伴侣
company|公司；陪伴
compare|比较，对比
comparison|比较，对照
compete|竞争，比赛
competition|竞争，比赛
competitor|竞争者，对手
complain|抱怨，投诉
complaint|投诉，抱怨
complete|完全的；完成
complex|复杂的；复合的
component|组成部分，成分
compose|组成；作曲
composition|作文；成分
comprehension|理解（力）
comprehensive|全面的，综合的
computer|计算机，电脑
concentrate|集中；浓缩
concept|概念，观念
concern|关心；涉及
concerned|担心的；有关的
concert|音乐会，演唱会
conclude|推断出；结束
conclusion|结论，结束
concrete|具体的；混凝土
condition|条件；状况
conduct|行为；引导
conference|会议，研讨会
confidence|信心，自信
confident|自信的，确信的
confine|限制；监禁
confirm|确认，证实
conflict|冲突，矛盾
confuse|使困惑；混淆
confusion|困惑，混乱
connect|连接，联系
connection|连接，关系
conquer|征服，战胜
consequence|结果，后果
consequently|因此，所以
conservation|保存，保护
conservative|保守的，守旧的
consider|考虑，认为
considerable|相当大的，可观的
considerate|体贴的，考虑周到的
consist|由...组成
consistent|一致的，始终如一的
constant|不断的，持续的
constitute|组成，构成
constitution|宪法；体质
construct|建造，建设
construction|建设，建筑物
consult|咨询，商量
consume|消耗，消费
consumption|消费，消耗
contact|接触；联系
contain|包含，容纳
container|容器，集装箱
contemporary|当代的，同时代的
content|内容；满意的
contest|竞赛，比赛
context|上下文，语境
continent|大陆，洲
continue|继续，持续
contract|合同；收缩
contradiction|矛盾，冲突
contrary|相反的；对立面
contrast|对比，对照
contribute|贡献；捐助
contribution|贡献，捐款
control|控制，管理
controversial|有争议的，引起争议的
controversy|争议，争论
convenience|便利，方便
convenient|方便的，便利的
convention|大会；惯例
conventional|传统的，常规的
conversation|谈话，交谈
convert|转变，转换
convey|表达，传达
convince|说服，使确信
cook|烹饪，做饭
cookie|饼干
cool|凉爽的；酷的
copy|复制；副本
core|核心，要点
corn|玉米，谷物
corner|角落，拐角
correct|正确的，恰当的
correspond|符合；通信
cost|花费；成本
cottage|小屋，村舍
cotton|棉花；棉布
cough|咳嗽
could|能，可以（can的过去式）
count|数数；认为
counter|柜台；计数器
country|国家；乡村
countryside|乡下，农村
couple|一对；夫妻
courage|勇气，胆量
course|课程；过程
court|法院；球场
courtyard|庭院，院子
cousin|堂（表）兄弟姐妹
cover|覆盖；封面
cow|母牛，奶牛
crack|裂缝；爆裂声
craft|工艺；手艺
crash|碰撞；坠毁
crawl|爬行，蠕动
crazy|疯狂的，荒唐的
cream|奶油，乳脂
create|创造，产生
creative|有创造力的，创造性的
creature|生物，动物
credit|信用；学分
crime|罪行，犯罪
criminal|罪犯；犯罪的
crisis|危机，紧要关头
critic|批评家，评论家
critical|关键的；批评的
criticism|批评，指责
criticize|批评，评论
crop|农作物；庄稼
cross|穿过；十字架
crowd|人群；拥挤
crown|王冠，皇冠
crucial|至关重要的，决定性的
cruel|残酷的，残忍的
cry|哭，叫喊
culture|文化，文明
cup|杯子，奖杯
cupboard|橱柜，衣柜
cure|治愈；疗法
curious|好奇的，奇怪的
currency|货币，通货
curriculum|课程
curtain|窗帘，门帘
curve|曲线，弯曲
custom|习惯，风俗
customer|顾客，客户
cut|切，割
cycle|循环，周期
daily|每日的；日报
dairy|乳制品；牛奶场
dam|水坝，堤坝
damage|损害，损毁
dance|跳舞，舞蹈
danger|危险
dangerous|危险的
dare|敢，敢于
dark|黑暗的，暗色的
darkness|黑暗，阴暗
data|数据，资料
date|日期，约会
daughter|女儿
day|天，白天
dead|死的，失去生命的
deadline|最后期限，截止日期
deaf|聋的
deal|交易，大量
dealer|商人，贩子
dear|亲爱的，昂贵的
death|死亡
debate|辩论，争论
debt|债务，欠款
decade|十年，十年期
decide|决定，下决心
decision|决定，抉择
declare|宣布，声明
decline|下降，拒绝
decorate|装饰，装潢
decrease|减少，降低
dedicate|奉献，献身
deed|行为，事迹
deep|深的，纵深的
deer|鹿
define|定义，界定
definite|明确的，一定的
definition|定义，释义
degree|程度，学位
delay|耽搁，延迟
delete|删除，删去
delicate|精致的，脆弱的
delicious|美味的，可口的
delight|快乐，高兴
deliver|递送，发表
delivery|递送，分娩
demand|要求，需求
democracy|民主，民主制
democratic|民主的，民主制的
demonstrate|证明，示范
dense|密集的，稠密的
density|密度，浓度
dental|牙齿的，牙科的
deny|否认，拒绝
depart|离开，出发
department|部门，系
depend|依赖，依靠
dependent|依赖的，依靠的
deposit|存款，押金
depress|使沮丧，压下
depth|深度，深处
describe|描述，形容
description|描述，形容
desert|沙漠；遗弃
deserve|应得，值得
design|设计，构思
designer|设计者，设计师
desire|愿望，要求
desk|书桌，办公桌
desperate|绝望的，孤注一掷的
despite|尽管，不管
dessert|甜点，甜食
destination|目的地，终点
destroy|破坏，毁坏
detail|细节，详情
detect|察觉，发现
determination|决心，决定
determine|决定，确定
develop|发展，开发
development|发展，发育
device|设备，装置
devil|魔鬼，家伙
devise|设计，发明
devote|奉献，致力于
diagram|图表，图解
dial|拨号；刻度盘
dialogue|对话，对白
diamond|钻石，菱形
diary|日记，日志
dictate|口述；命令
dictionary|字典，词典
die|死亡，熄灭
diet|饮食，节食
differ|不同，相异
difference|差异，不同
different|不同的，有差异的
difficult|困难的，费力的
difficulty|困难，难题
dig|挖，掘
digest|消化；摘要
digital|数字的，数码的
dignity|尊严，高贵
dilemma|困境，进退两难
dimension|尺寸，维度
dinner|晚餐，晚宴
dip|浸，蘸
direct|直接的；指挥
direction|方向，指导
directly|直接地，立即
director|导演，主管
directory|目录，指南
dirt|污垢，泥土
dirty|脏的，肮脏的
disability|残疾，无能
disable|使丧失能力
disagree|不同意，有分歧
disappear|消失，不见
disappoint|使失望
disaster|灾难，灾祸
disc|圆盘，磁盘
discard|丢弃，抛弃
discharge|释放；排出
discipline|纪律；学科
disclose|揭露，透露
discourage|使泄气，阻碍
discover|发现，发觉
discovery|发现，发觉
discuss|讨论，议论
discussion|讨论，辩论
disease|疾病，病害
disgust|厌恶，反感
dish|盘子，菜肴
disk|磁盘，圆盘
dislike|不喜欢，厌恶
dismiss|解雇；解散
disorder|混乱，骚乱
display|展示，陈列
dispute|争论，争端
dissolve|溶解；解散
distance|距离，远处
distant|遥远的，远离的
distinct|清晰的，明显的
distinction|区别，荣誉
distinguish|区分，辨别
distribute|分配，分发
district|地区，区域
disturb|打扰，妨碍
ditch|沟渠，壕沟
dive|跳水，潜水
diverse|多样的，不同的
divide|分开，划分
division|划分，部门
divorce|离婚；分离
do|做，干
doctor|医生，博士
document|文件，公文
dog|狗，犬
dollar|美元，元（货币单位）
door|门，出入口
dormitory|宿舍，寝室
double|双倍的；加倍
doubt|怀疑，疑问
down|向下，朝下
download|下载
downstairs|在楼下，往楼下
downtown|市中心，商业区
dozen|一打，十二个
draft|草案，草图
drag|拖，拉
drama|戏剧，剧本
dramatic|戏剧性的，引人注目的
draw|画，拉
drawer|抽屉
drawing|图画，素描
dream|梦想，梦
dress|连衣裙；穿衣
drift|漂流，漂移
drill|钻孔；训练
drink|喝，饮料
drive|驾驶，驱车
driver|司机，驾驶员
drop|落下，滴
drug|药物，毒品
drum|鼓，鼓声
drunk|醉的，喝醉了的
dry|干的，干燥的
duck|鸭子，鸭肉
due|由于；应支付的
dull|枯燥的，沉闷的
dumb|哑的，无言的
dump|倾倒，倾卸
durable|耐用的，持久的
duration|持续时间，期间
during|在...期间
dust|灰尘，尘土
duty|责任，义务
DVD|数字视频光盘
dynamic|动态的，有活力的
each|每个，各自
eager|渴望的，热切的
eagle|鹰，雕
ear|耳朵，听觉
early|早的，早期的
earn|赚得，获得
earnest|认真的，诚挚的
earth|地球，土地
earthquake|地震
ease|容易，舒适
easily|容易地，不费力地
east|东方的，东部的
eastern|东方的，东部的
easy|容易的，简单的
eat|吃，吃饭
echo|回声，回音
economical|节约的，经济的
economic|经济的，经济学的
economics|经济学
economist|经济学家
economy|经济，节约
edge|边缘，边线
edition|版本，版
editor|编辑，编者
educate|教育，培养
education|教育，培养
educational|教育的，有教育意义的
effect|效果，影响
effective|有效的，起作用的
efficiency|效率，功效
efficient|高效的，有能力的
effort|努力，尽力
egg|鸡蛋，卵
eight|八
eighteen|十八
eighth|第八
eighty|八十
either|或者，也
elaborate|详尽的；精心制作的
elastic|有弹性的，灵活的
elbow|肘，肘部
elder|年长的，资格老的
elect|选举，推选
election|选举，当选
electric|电的，电动的
electrical|与电有关的
electricity|电，电流
electronic|电子的，电子设备的
element|元素，要素
elementary|基本的，初级的
elephant|大象
elevator|电梯，升降机
eleven|十一
eligible|有资格的，符合条件的
eliminate|消除，排除
elite|精英，杰出人物
else|其他的，别的
e-mail|电子邮件
embarrass|使尴尬，使为难
embrace|拥抱；欣然接受
emerge|浮现，出现
emergency|紧急情况，突发事件
emit|散发，发射
emotion|情感，情绪
emotional|情感的，情绪的
emphasis|强调，重点
emphasize|强调，着重
empire|帝国
employ|雇佣，使用
employee|雇员，员工
employer|雇主，老板
employment|就业，雇佣
empty|空的，空虚的
enable|使能够，使可能
enclose|围住，封入
encounter|遭遇，遇到
encourage|鼓励，激励
encouragement|鼓励，激励
end|结束，末端
ending|结局，结尾
endless|无尽的，永无止境的
endorse|支持，赞同
endure|忍受，忍耐
enemy|敌人，仇敌
energy|精力，能量
enforce|实施，执行
engage|从事，占用
engine|发动机，引擎
engineer|工程师，技师
engineering|工程，工程学
enjoy|享受，喜爱
enlarge|扩大，放大
enormous|巨大的，庞大的
enough|足够的，充分的
ensure|确保，保证
enter|进入，参加
entertain|娱乐，招待
enthusiasm|热情，热心
entire|全部的，整个的
entitle|给...权利，给...题名
entrance|入口，进入
entry|进入，入口处
environment|环境，外界
environmental|环境的，有关环境的
episode|插曲，片段
equal|相等的，平等的
equality|平等，同等
equip|装备，配备
equipment|设备，器材
era|时代，纪元
error|错误，过失
escape|逃跑，逃脱
especially|特别，尤其
essay|散文，随笔
essential|必不可少的，本质的
establish|建立，设立
establishment|建立，机构
estimate|估计，估价
etc.|等等，以及其他
ethic|道德规范，伦理标准
ethnic|种族的，民族的
evaluate|评估，评价
evaporate|蒸发，挥发
eve|前夕，前一天
even|甚至，即使
evening|晚上，傍晚
event|事件，大事
eventually|最终，最后
ever|曾经，永远
every|每个的，每一的
everybody|每人，人人
everyday|日常的，每天的
everyone|每人，人人
everything|每件事，一切
everywhere|到处，处处
evidence|证据，证明
evident|明显的，显然的
evil|邪恶的，罪恶的
evolution|进化，演变
exact|精确的，准确的
exactly|确切地，恰恰
exaggerate|夸大，夸张
exam|考试，测验
examination|考试，检查
examine|检查，调查
example|例子，榜样
exceed|超过，超出
excellent|优秀的，极好的
except|除了...之外
exception|例外，除外
exchange|交换，交流
excite|使兴奋，刺激
exciting|令人兴奋的，激动人心的
exclude|排除，排斥
excuse|借口；原谅
exercise|练习，锻炼
exert|运用，发挥
exhaust|使筋疲力尽；排气
exhibit|展览，展示
exist|存在，生存
existence|存在，生存
exit|出口，通道
expand|扩大，扩展
expansion|扩张，膨胀
expect|期望，预料
expectation|期望，预期
expense|费用，开支
expensive|昂贵的，花钱多的
experience|经验，经历
experiment|实验，试验
expert|专家，能手
explain|解释，说明
explanation|解释，说明
explode|爆炸，爆发
exploit|利用；剥削
explore|探索，勘探
explosion|爆炸，爆发
explosive|爆炸性的；炸药
export|出口，输出
expose|暴露，揭露
express|表达；快车
expression|表达，词语
extend|延伸，延长
extension|延伸，扩展
extensive|广泛的，广阔的
extent|程度，范围
external|外部的，外面的
extra|额外的，另外的
extraordinary|非同寻常的，特别的
extreme|极度的，极端的
eye|眼睛，视力
face|脸，面部
facility|设施，设备
fact|事实，真相
factor|因素，要素
factory|工厂，制造厂
faculty|能力，系
fade|褪色，逐渐消失
fail|失败，不及格
failure|失败，失败者
faint|微弱的；头晕的
fair|公平的，公正的
fairly|公平地，相当地
faith|信仰，信念
fall|落下，跌倒
false|错误的，假的
fame|名声，声誉
familiar|熟悉的，常见的
family|家庭，家族
famine|饥荒，饥饿
famous|著名的，出名的
fan|风扇；狂热爱好者
fancy|花哨的；想象
fantastic|极好的，奇异的
fantasy|幻想，想象
fare|车费，船费
farm|农场，农庄
farmer|农民，农场主
fashion|时尚，流行
fashionable|流行的，时髦的
fast|快的，迅速的
fasten|系紧，扣上
fat|胖的，肥的
fate|命运，宿命
father|父亲，爸爸
fault|错误，过失
favo(u)rite|最喜欢的
fear|害怕，恐惧
feasible|可行的，可能的
feather|羽毛，翎毛
feature|特征，特色
federal|联邦的，同盟的
fee|费用，酬金
feed|喂养，饲养
feel|感觉，触摸
feeling|感觉，情感
fellow|同伴，家伙
female|女性的，雌性的
fence|栅栏，围墙
fertile|肥沃的，多产的
fertilizer|肥料，化肥
festival|节日，喜庆日
fetch|取来，接来
fever|发烧，发热
few|很少的，几乎没有的
fiber|纤维，纤维质
fiction|小说，虚构
field|田野，领域
fierce|凶猛的，猛烈的
fifteen|十五
fifth|第五
fifty|五十
fight|打架，战斗
figure|数字，人物
file|文件，档案
fill|填满，装满
film|电影，胶卷
filter|过滤，筛选
final|最终的，最后的
finally|最后，终于
finance|财政，金融
financial|财政的，金融的
find|找到，发现
finding|发现，调查结果
fine|好的，健康的
finger|手指
finish|完成，结束
fire|火，火灾
firm|公司；坚定的
first|第一的，首先的
fish|鱼，钓鱼
fist|拳头，拳击
fit|适合的；安装
five|五
fix|修理，固定
flag|旗帜，标志
flame|火焰，火舌
flash|闪光，闪现
flat|平坦的；公寓
flavor|味道，风味
flee|逃跑，逃离
flesh|肉，肉体
flexible|灵活的，柔韧的
flight|航班，飞行
float|漂浮，浮动
flood|洪水，水灾
floor|地板，楼层
flour|面粉，粉
flow|流动，流量
flower|花，花朵
fluent|流利的，流畅的
fluid|流体，液体
fly|飞，飞行
focus|焦点；集中
fog|雾，烟雾
fold|折叠，对折
folk|人们，家属
follow|跟随，遵循
following|接下来的，下列的
fond|喜爱的，喜欢的
food|食物，食品
fool|傻瓜，愚人
foolish|愚蠢的，可笑的
foot|脚，英尺
football|足球，橄榄球
for|为了，因为
force|力量，武力
forecast|预测，预报
forehead|前额，额头
foreign|外国的，外来的
foreigner|外国人
forest|森林，林区
forever|永远，长久地
forget|忘记，遗忘
forgive|原谅，宽恕
fork|叉子，岔路
form|形式，表格
formal|正式的，正规的
format|格式，版式
formation|形成，构成
former|以前的，从前的
formula|公式，方程式
forth|向前，向外
fortnight|两星期，十四天
fortunate|幸运的，侥幸的
fortune|运气，财富
forty|四十
forward|向前的；转发
fossil|化石，僵化的事物
foster|养育，培养
found|建立，创立
foundation|基础，基金会
four|四
fourteen|十四
fourth|第四
fox|狐狸，狡猾的人
fraction|小部分，分数
fragile|易碎的，脆弱的
fragment|碎片，片段
frame|框架，构架
framework|框架，结构
France|法国
frank|坦率的，直率的
free|免费的；自由的
freedom|自由，自主
freeze|结冰，冻结
freight|货物，运费
French|法国的，法语的
frequency|频率，发生率
frequent|频繁的，经常的
fresh|新鲜的，清新的
friction|摩擦，摩擦力
Friday|星期五
fridge|冰箱
friend|朋友，友人
friendly|友好的，亲切的
friendship|友谊，友情
fright|惊吓，恐怖
frighten|使惊吓，吓唬
from|从...，来自
front|前面，前线
fruit|水果，果实
frustrate|使沮丧，挫败
fry|油炸，油煎
fuel|燃料，能量
fulfill|履行，实现
full|满的，完全的
fun|有趣，娱乐
function|功能，作用
fund|基金，资金
fundamental|基本的，根本的
funeral|葬礼，丧礼
funny|有趣的，滑稽的
fur|毛皮，软毛
furious|狂怒的，暴怒的
furnace|炉子，熔炉
furniture|家具，装置
further|进一步的；更远地
furthermore|此外，而且
future|未来，将来
gain|获得，赢得
gallery|画廊，走廊
gallon|加仑
game|游戏，比赛
gang|一帮，一群
gap|缺口，差距
garage|车库，汽车修理厂
garbage|垃圾，废物
garden|花园，菜园
gardening|园艺，园艺学
gardener|园丁，花匠
gas|气体，煤气
gate|大门，入口
gather|聚集，集合
gathering|聚会，集会
gay|快乐的，同性恋的
gaze|凝视，注视
general|一般的，总的
generally|一般地，通常地
generate|产生，引起
generation|一代，一代人
generator|发电机，发生器
generous|慷慨的，大方的
genetic|遗传的，基因的
gentle|温和的，文雅的
gentleman|绅士，先生
genuine|真正的，真诚的
geography|地理，地理学
geometry|几何学，几何图形
germ|细菌，微生物
German|德国的，德国人
Germany|德国
gesture|手势，姿势
get|得到，变得
ghost|鬼魂，幽灵
giant|巨大的，巨人
gift|礼物，天赋
girl|女孩，姑娘
give|给予，提供
given|特定的，假设的
glad|高兴的，乐意的
glance|一瞥，扫视
glass|玻璃；杯子
glove|手套
glory|光荣，荣誉
glove|手套
glue|胶水，胶粘剂
go|去，走
goal|目标，球门
goat|山羊
god|神，上帝
gold|金，黄金
golden|金色的，黄金般的
golf|高尔夫球
good|好的，优秀的
goodbye|再见，再会
goods|商品，货物
gorgeous|华丽的，灿烂的
govern|统治，管理
government|政府，内阁
governor|统治者，州长
gown|长袍，礼服
grab|抓住，攫取
grace|优美，优雅
graceful|优雅的，优美的
grade|等级，年级
gradual|逐渐的，逐步的
graduate|毕业生；毕业
graduation|毕业，毕业典礼
grain|谷物，颗粒
gram|克（重量单位）
grammar|语法，文法
grand|宏大的，重大的
grandfather|祖父，爷爷
grandmother|祖母，奶奶
grant|授予，给予
grape|葡萄
graph|图表，曲线图
grasp|抓住，理解
grass|草，草地
grateful|感激的，感谢的
grave|严重的，重大的
gravity|重力，严重性
great|伟大的，巨大的
greedy|贪婪的，贪心的
green|绿色的，环保的
greenhouse|温室，暖房
greet|问候，打招呼
greeting|问候，致意
grey|灰色的，阴沉的
grocer|食品商，杂货商
grocery|食品杂货店
ground|地面，土地
group|组，群
grow|生长，种植
growth|增长，发展
guarantee|保证，担保
guard|警卫，保卫
guess|猜测，估计
guest|客人，宾客
guidance|指导，引导
guide|指南，向导
guideline|指导方针，准则
guilt|罪行，内疚
guilty|有罪的，内疚的
guitar|吉他，六弦琴
gun|枪，炮
guy|家伙，伙计
gym|体育馆，健身房
habit|习惯，习性
hair|头发，毛发
half|一半，半数
hall|大厅，礼堂
halt|停止，暂停
hand|手，协助
handful|一把；少数
handle|把手；处理
handsome|英俊的，漂亮的
handwriting|书法，笔迹
handy|方便的，手边的
hang|悬挂，吊着
happen|发生，碰巧
happy|快乐的，幸福的
harbor|海港，避难所
hard|困难的；硬的
harden|使变硬，坚定
hardly|几乎不，简直不
hardship|艰难，困苦
hardware|硬件，五金
harm|伤害，损害
harmony|和谐，融洽
harness|利用，治理
harsh|严厉的，刺耳的
harvest|收获，收割
hat|帽子
hate|憎恨，讨厌
hatred|仇恨，憎恶
have|有，拥有
hawk|鹰，鹰派人物
hay|干草，稻草
hazard|危险，危害
he|他
head|头，头部
headache|头痛
headline|大字标题，新闻提要
headquarters|总部，司令部
heal|治愈，愈合
health|健康，卫生
healthy|健康的，健壮的
heap|堆，大量
hear|听见，听说
hearing|听力，听觉
heart|心脏，内心
heat|热，热度
heaven|天堂，天空
heavy|重的，沉重的
heel|脚后跟，鞋跟
height|高度，身高
helicopter|直升机
hell|地狱，苦境
hello|你好，喂
help|帮助，援助
helpful|有帮助的，有益的
hen|母鸡，雌禽
her|她的，她
herb|草药，香草
herd|兽群，牧群
here|这里，此处
hero|英雄，男主角
heroic|英雄的，英勇的
hers|她的（所有物）
herself|她自己
hesitate|犹豫，迟疑
hi|嗨，你好
hide|隐藏，躲避
high|高的，高级的
highlight|突出，强调
highly|高度地，非常
highway|公路，大路
hill|小山，山丘
him|他（宾格）
himself|他自己
hint|暗示，线索
hip|臀部，髋骨
hire|雇佣，租用
his|他的
historical|历史的，史学的
history|历史，经历
hit|打，击中
hobby|业余爱好，嗜好
hold|握住，举行
hole|洞，孔
holiday|假期，假日
hollow|空的，空心的
holy|神圣的，圣洁的
home|家，家庭
homework|家庭作业
honest|诚实的，正直的
honesty|诚实，正直
honey|蜂蜜，亲爱的
honor|荣誉，荣幸
hope|希望，期望
hopeful|有希望的，有前途的
horizon|地平线，视野
horizontal|水平的，横的
horn|号角，喇叭
horrible|可怕的，恐怖的
horror|恐怖，战栗
horse|马，马匹
hospital|医院，诊所
host|主人；主持人
hostess|女主人，空姐
hot|热的，辣的
hotel|旅馆，酒店
hour|小时，时刻
house|房子，住宅
household|家庭的；家务
housewife|家庭主妇
housework|家务劳动
how|如何，怎样
however|然而，无论如何
huge|巨大的，庞大的
human|人类的，人的
humor|幽默，诙谐
humorous|幽默的，诙谐的
hundred|一百
hunger|饥饿，渴望
hungry|饥饿的，渴望的
hunt|打猎，搜寻
hunter|猎人，搜寻者
hurry|匆忙，赶紧
hurt|伤害，刺痛
husband|丈夫
hut|小屋，棚屋
hydrogen|氢，氢气
ice|冰，冰块
ice-cream|冰淇淋
idea|想法，主意
ideal|理想的，完美的
identical|完全相同的，同一的
identify|识别，鉴别
identity|身份，特征
idiom|习语，成语
if|如果，是否
ignorance|无知，愚昧
ignorant|无知的，愚昧的
ignore|忽视，不理睬
ill|生病的，坏的
illegal|非法的，违法的
illness|疾病，病痛
illustrate|说明，阐明
image|形象，图像
imagination|想象，想象力
imagine|想象，设想
imitate|模仿，仿效
immediate|立即的，即刻的
immense|巨大的，广大的
immigrant|移民，侨民
impact|影响，冲击
impatient|不耐烦的，急躁的
implement|实施，执行
implication|含义，暗示
imply|暗示，意味
import|进口，输入
importance|重要性，价值
important|重要的，重大的
impossible|不可能的，办不到的
impress|给...留下印象
impression|印象，感觉
improve|改善，改进
improvement|改善，改进
incident|事件，事变
include|包括，包含
income|收入，所得
increase|增加，增长
increasingly|越来越多地，渐增地
indeed|确实，的确
independence|独立，自主
independent|独立的，自主的
index|索引，指标
Indian|印度的；印第安人的
indicate|表明，暗示
indication|指示，迹象
indifferent|冷漠的，不感兴趣的
indirect|间接的，迂回的
indispensable|必不可少的，必需的
individual|个人的，单独的
indoor|室内的
industrial|工业的，产业的
industry|工业，行业
inevitable|不可避免的，必然的
infect|传染，感染
infer|推断，推论
inference|推论，结论
infinite|无限的，无穷的
influence|影响，作用
influential|有影响力的，有权势的
inform|通知，告知
information|信息，资料
ingredient|成分，原料
inhabit|居住于，栖息于
inhabitant|居民，住户
inherit|继承，遗传
initial|最初的，开头的
initiative|主动性，首创精神
injure|伤害，损害
injury|伤害，损害
ink|墨水，油墨
inn|小旅馆，客栈
inner|内部的，内心的
innocent|无辜的，清白的
innovation|创新，革新
input|输入，投入
inquire|询问，调查
inquiry|询问，调查
insect|昆虫，虫子
insert|插入，嵌入
inside|在里面，在内部
insist|坚持，坚决要求
inspect|检查，视察
inspection|检查，视察
inspire|鼓舞，激励
instant|瞬间，立即的
instead|代替，反而
instinct|本能，直觉
institute|学院，研究所
institution|机构，惯例
instruct|指示，命令
instruction|指令，教导
instrument|仪器，工具
insurance|保险，保险费
insure|给...保险
integrate|使结合，使一体化
integrity|完整，正直
intellectual|智力的，知识分子
intelligence|智力，情报
intelligent|聪明的，有才智的
intend|打算，想要
intense|强烈的，紧张的
intensity|强度，烈度
intensive|加强的，集中的
intention|意图，目的
interaction|互动，交流
interest|兴趣，利息
interesting|有趣的，引人入胜的
interfere|干涉，干扰
interference|干涉，干扰
interior|内部的，内地的
intermediate|中间的，中级的
internal|内部的，国内的
international|国际的，世界的
interpret|口译，解释
interpretation|解释，口译
interrupt|打断，中断
interval|间隔，间歇
interview|面试，采访
intimate|亲密的，私人的
introduce|介绍，引进
introduction|介绍，引进
invade|入侵，侵略
invasion|入侵，侵略
invent|发明，创造
invention|发明，创造
inventor|发明家，创造者
invest|投资，投入
investigate|调查，研究
investment|投资，投入
invite|邀请，招待
involve|涉及，包含
involvement|卷入，牵连
iron|铁，熨斗
irregular|不规则的，不整齐的
island|岛屿，岛
isolate|使孤立，隔离
issue|问题，发行
it|它
Italian|意大利的，意大利人的
item|项目，条款
its|它的
itself|它自己
jacket|夹克，外套
jail|监狱，看守所
jam|果酱；堵塞
January|一月
jar|罐子，广口瓶
jaw|下巴，颌
jazz|爵士乐
jealous|嫉妒的，吃醋的
jeans|牛仔裤
jet|喷气式飞机；喷射
jewel|宝石，珠宝
job|工作，职业
join|连接，参加
joint|关节；连接的
joke|笑话，玩笑
journal|日报，日志
journalist|记者，新闻工作者
journey|旅程，旅行
joy|快乐，喜悦
judge|法官，裁判
judgment|判断，裁判
juice|果汁，液汁
July|七月
jump|跳跃，跳动
June|六月
jungle|丛林，密林
junior|初级的，年少的
jury|陪审团，评委会
just|公正的；刚才
justice|正义，公正
justify|证明...是正当的
keen|热切的，敏锐的
keep|保持，保留
kettle|水壶，锅
key|钥匙，关键
keyboard|键盘
kick|踢，反冲
kid|小孩，孩子
kill|杀死，扼杀
kilo|千克，公里
kilogram|千克，公斤
kilometer|千米，公里
kind|亲切的，种类
kindergarten|幼儿园
king|国王，君主
kingdom|王国，领域
kiss|吻，亲吻
kitchen|厨房，灶间
knee|膝盖，膝部
knife|刀，餐刀
knock|敲，击打
know|知道，了解
knowledge|知识，学问
lab|实验室，研究室
label|标签，标记
labor|劳动，劳力
laboratory|实验室，研究室
lack|缺乏，不足
ladder|梯子，阶梯
lady|女士，夫人
lake|湖，湖泊
lamb|羔羊，小羊
lamp|灯，台灯
land|陆地，土地
landing|楼梯平台，着陆
landlord|房东，地主
lane|小路，车道
language|语言，言语
lantern|灯笼，灯塔
lap|一圈，大腿
large|大的，巨大的
largely|主要地，大量地
laser|激光
last|最后的，最近的
late|晚的，迟的
lately|最近，不久前
later|后来，稍后
Latin|拉丁语的，拉丁人的
latter|后者的，后一半的
laugh|笑，大笑
laughter|笑声，笑料
launch|发射，发起
laundry|洗衣店，待洗衣物
lavatory|厕所，盥洗室
law|法律，法规
lawn|草坪，草地
lawyer|律师，法学家
lay|放置，铺设
layer|层，层次
layman|外行，俗人
lazy|懒惰的，懒散的
lead|领导，引导
leader|领导者，领袖
leadership|领导，领导地位
leading|主要的，首要的
leaf|叶子，页
league|联盟，社团
leak|漏洞，泄漏
lean|倾斜，依靠
learn|学习，学会
learned|博学的，有学问的
learning|学习，知识
least|最小的，最少的
leather|皮革，皮制品
leave|离开，留下
lecture|讲座，讲课
left|左边的，左侧的
leg|腿，支柱
legal|法律的，合法的
legend|传说，传奇
lemon|柠檬
lend|借给，借出
length|长度，长
lens|透镜，镜头
less|更少的，较小的
lessen|减少，减轻
lesson|课程，教训
let|让，允许
letter|信，字母
level|水平，等级
lever|杠杆，工具
liability|责任，债务
liable|有责任的，有...倾向的
liberal|自由的，慷慨的
liberate|解放，释放
liberty|自由，自由权
library|图书馆，藏书
license|执照，许可证
lick|舔，舔吃
lid|盖子，盖
lie|躺，位于
lie|说谎，撒谎
life|生命，生活
lifetime|一生，终生
lift|电梯，举起
light|光，光线
lightning|闪电，雷电
like|喜欢，喜爱
likely|可能的，有希望的
limit|限制，限度
limited|有限的，受限的
line|线，线条
link|链接，联系
lion|狮子，猛兽
lip|嘴唇，唇边
liquid|液体，液态的
list|列表，清单
listen|听，倾听
liter|升（容量单位）
literary|文学的，书面的
literature|文学，文献
litter|垃圾，废物
little|小的，很少的
live|居住，生活
lively|活泼的，充满活力的
liver|肝脏，生活者
living|活着的，生活的
load|负载，负荷
loaf|一条面包，游荡
loan|贷款，借出
local|当地的，局部的
locate|位于，坐落于
location|位置，地点
lock|锁，锁住
locomotive|火车头，机车
log|原木，日志
logic|逻辑，逻辑学
logical|逻辑的，合乎逻辑的
lonely|孤独的，寂寞的
long|长的，长期的
longitude|经度，经线
look|看，看起来
loop|环，圆圈
loose|松的，宽松的
loosen|松开，放松
lord|上帝，贵族
lorry|卡车，货车
lose|丢失，失去
loss|损失，亏损
lost|迷失的，丢失的
lot|许多，大量
loud|大声的，响亮的
loudspeaker|扬声器，扩音器
love|爱，热爱
lovely|可爱的，美好的
lover|爱好者，情人
low|低的，矮的
lower|较低的，下级的
loyal|忠诚的，忠心的
loyalty|忠诚，忠心
luck|运气，好运
lucky|幸运的，走运的
luggage|行李，皮箱
lump|块，团
lunch|午餐，午饭
lung|肺，肺脏
luxury|奢侈，奢华
machine|机器，机械
machinery|机械，机器（总称）
mad|发疯的，生气的
magazine|杂志，期刊
magic|魔法，魔术
magician|魔术师，巫师
magnet|磁铁，磁体
magnetic|磁性的，有吸引力的
magnificent|壮丽的，宏伟的
maid|女仆，侍女
mail|邮件，邮政
main|主要的，首要的
mainland|大陆，本土
mainly|主要地，大部分
maintain|维持，保持
maintenance|维护，保养
major|主要的，重大的
majority|大多数，大部分
make|制造，使得
male|男性的，雄性的
mall|购物中心，林荫大道
man|男人，人
manage|管理，经营
management|管理，经营
manager|经理，管理人员
mandate|命令，授权
maneuver|策略，花招
manner|方式，态度
manual|手册，指南
manufacture|制造，加工
manufacturer|制造商，厂商
many|许多的，大量的
map|地图，天体图
marathon|马拉松赛跑
marble|大理石，弹珠
march|三月；行军
margin|页边空白；利润
marginal|微小的，边缘的
marine|海生的，海产的
mark|标记，分数
market|市场，销路
marriage|结婚，婚姻
married|已婚的，婚姻的
marry|结婚，嫁，娶
mask|面具，口罩
mass|大量，团
massive|巨大的，大规模的
master|主人，大师
match|比赛，火柴
mate|伙伴，同事
material|材料，原料
math|数学
mathematics|数学
matter|事情，物质
mature|成熟的，到期的
maximum|最大值，最大限度
may|可以，也许
maybe|大概，或许
mayor|市长
me|我（宾格）
meal|一餐，膳食
mean|意思是，意味着
meaning|意义，含义
means|方法，手段
meantime|其间，同时
meanwhile|同时，当...的时候
measure|测量，衡量
meat|肉，肉类
mechanic|技工，机修工
mechanical|机械的，力学的
mechanism|机制，机械装置
medial|媒体，媒介
edit|编辑，剪辑
medical|医学的，医疗的
medicine|药，医学
medium|中等的，媒介
meet|遇见，满足
meeting|会议，集会
melon|瓜，甜瓜
member|成员，会员
membership|会员资格，成员身份
memo|备忘录
memorial|纪念物，纪念碑
memory|记忆，内存
mend|修理，修补
mental|精神的，脑力的
mention|提及，说起
menu|菜单，饭菜
mercy|仁慈，宽恕
merchant|商人，生意人
mercury|水银，汞
mercy|仁慈，宽容
mere|仅仅，只不过
merely|仅仅，只不过
merit|优点，价值
merry|愉快的，欢乐的
mess|混乱，脏乱
message|消息，信息
messy|凌乱的，肮脏的
metal|金属，合金
meter|米，仪表
method|方法，办法
metre|米，公尺
metric|公制的，米制的
middle|中间的，中部的
midnight|午夜，半夜
might|可能，也许
migrate|迁移，移居
mild|温和的，轻微的
mile|英里
militant|好斗的，激进的
military|军事的，军用的
milk|牛奶，乳汁
mill|工厂，磨坊
million|百万，百万个
mind|头脑，精神
mine|我的（所有物）
mineral|矿物，矿物质
minimum|最小值，最低限度
minister|部长，大臣
minor|较小的，次要的
minority|少数，少数民族
minus|减去，负的
minute|分钟，片刻
miracle|奇迹，奇事
mirror|镜子，反映
miserable|痛苦的，悲惨的
mislead|误导，将...引入歧途
miss|想念，错过
missile|导弹，飞弹
mist|薄雾，雾霭
mistake|错误，过失
mistress|女主人，情妇
misunderstand|误解，误会
mix|混合，搅拌
mixture|混合物，混合体
moan|呻吟，抱怨
mobile|移动的，易变的
mode|方式，模式
model|模型，模特
moderate|适度的，中等的
modern|现代的，近代的
modest|谦虚的，适度的
modify|修改，更改
moist|潮湿的，湿润的
moisture|水分，湿气
molecule|分子，微粒
moment|时刻，瞬间
Monday|星期一
money|钱，货币
monitor|监视器，班长
monster|怪物，妖怪
month|月，月份
mood|情绪，心情
moon|月亮，月球
moral|道德的，道义的
more|更多的，另外的
moreover|而且，此外
morning|早晨，上午
mortgage|抵押贷款
most|最多的，大多数的
mostly|主要地，大部分
mother|母亲，妈妈
motion|运动，手势
motivate|激发，激励
motive|动机，目的
motor|发动机，马达
mount|登上，爬上
mountain|山，山脉
mouse|老鼠，耗子
mouth|嘴，口
move|移动，搬家
movement|运动，动作
movie|电影，影片
much|许多的，大量的
mud|泥，泥浆
multiply|乘，繁殖
murder|谋杀，凶杀
murderer|凶手，谋杀犯
muscle|肌肉，体力
music|音乐，乐曲
musical|音乐的，悦耳的
musician|音乐家，乐师
must|必须，一定
mutton|羊肉
mutual|相互的，共同的
my|我的
myself|我自己
mysterious|神秘的，不可思议的
nail|钉子，指甲
naked|裸体的，无遮蔽的
name|名字，名称
namely|即，也就是
nap|小睡，打盹
napkin|餐巾纸，尿布
narrow|狭窄的，狭隘的
nation|国家，民族
national|国家的，国民的
nationality|国籍，民族
native|本土的，当地的
natural|自然的，正常的
naturally|自然地，天然地
nature|自然界，性质
naval|海军的，军舰的
navigation|导航，航行
navy|海军，舰队
near|近的，接近的
nearby|附近的，在附近
nearby|在附近；附近的
nearly|几乎，差不多
neat|整洁的；利索的
necessarily|必要地；必然地
necessary|必要的，必需的
neck|脖子，颈
necklace|项链
need|需要；必须
needle|针，指针
negative|消极的；否定的
neglect|忽视，忽略
negotiate|谈判，协商
Negro|黑人
neighbor|邻居
neighborhood|街区，邻近
neither|两者都不
nerve|神经；勇气
nervous|紧张的，神经质的
nest|巢，窝
net|网；净重
network|网络，网状系统
neutral|中立的，中性的
never|从未，绝不
nevertheless|然而，不过
new|新的，新鲜的
news|新闻，消息
newspaper|报纸
next|下一个的；其次
nice|美好的，友好的
niece|侄女，外甥女
night|夜晚，黑夜
nine|九
nineteen|十九
ninety|九十
ninth|第九
no|不；没有
noble|高尚的；贵族的
nobody|没有人，无名小卒
nod|点头
noise|噪音，喧闹声
noisy|嘈杂的，喧闹的
none|没有一个，毫无
nonetheless|尽管如此，然而
nonsense|胡说，废话
noon|中午，正午
nor|也不
normal|正常的，标准的
normally|正常地，通常地
north|北，北方
northeast|东北
northern|北方的，北部的
northwest|西北
nose|鼻子
not|不，没有
note|笔记；便条
notebook|笔记本
nothing|没有东西，无事
notice|注意；布告
noticeable|显而易见的
notify|通知，告知
notion|概念，想法
novel|小说
novelist|小说家
November|十一月
now|现在，目前
nowadays|如今，现在
nowhere|任何地方都不
nuclear|原子核的；核心的
number|数字；号码
numerous|众多的，许多的
nurse|护士；保姆
nut|坚果，螺母
nylon|尼龙，聚酰胺纤维
obey|服从，听从
object|物体；反对
objection|反对，异议
objective|客观的；目标
obligation|义务，责任
obscure|模糊的，晦涩的
observe|观察；遵守
observer|观察者，观察员
obstacle|障碍，障碍物
obtain|获得，得到
obvious|明显的，显而易见的
obviously|明显地，显而易见地
occasion|场合，时机
occasional|偶尔的，偶然的
occupation|职业，占用
occupy|占据，占领
occur|发生，出现
occurrence|发生，事件
ocean|海洋，大海
October|十月
odd|奇怪的；奇数的
odds|可能性，机会
odor|气味，名声
of|...的
off|离开；关闭
offend|冒犯，得罪
offense|冒犯，罪行
offer|提供；提议
office|办公室，职务
officer|官员，军官
official|官方的，正式的
offset|抵消，补偿
offspring|后代，子孙
often|经常，常常
oh|哦，啊
oil|油，石油
okay|好的，可以
old|老的，古老的
Olympic|奥林匹克的
omit|省略，遗漏
on|在...上；关于
once|一次；曾经
one|一，一个
ongoing|正在进行的，持续的
onion|洋葱，葱头
only|唯一的；仅仅
onto|到...上面
open|开着的；开放的
opening|开始；空缺
opera|歌剧
operate|操作，运转
operation|操作，手术
operator|操作员，接线员
opinion|意见，看法
opponent|对手，敌手
opportunity|机会，时机
oppose|反对，反抗
opposite|相反的；对面
oppress|压迫，压制
opt|选择，抉择
optical|光的，视力的
optimistic|乐观的，乐观主义的
option|选择，选项
or|或者；否则
oral|口头的，口述的
orange|橙子；橙色的
orbit|轨道；环绕
order|顺序；命令
orderly|整齐的；有秩序的
ordinary|普通的，平凡的
organ|器官；风琴
organic|有机的，有机体的
organism|生物体，有机体
organization|组织，机构
organize|组织，安排
origin|起源，出身
original|最初的；原创的
other|其他的，另外的
otherwise|否则；另外
ought|应该，应当
ounce|盎司，少量
our|我们的
ours|我们的（所有物）
ourselves|我们自己
out|出，在外
outcome|结果，后果
outdoor|户外的，露天的
outer|外部的，外面的
outlet|出口，插座
outline|大纲，轮廓
outlook|展望，观点
output|产量，输出
outside|外面的；在...外
outstanding|杰出的，突出的
outward|向外的，外出的
oven|烤箱，烤炉
over|在...上方；超过
overall|总体的；全部的
overcoat|大衣，外套
overcome|克服，战胜
overhead|头顶上的；管理费用
overlook|俯瞰；忽视
overnight|通宵的；突然的
overseas|海外的，在海外
overtake|追上，超过
owe|欠；归功于
own|自己的；拥有
owner|主人，物主
ownership|所有权，物主身份
ox|牛，公牛
oxygen|氧气，氧
pace|步速，速度
pacific|和平的，平静的
pack|包；打包
package|包裹，包
packet|小包，数据包
pad|垫；便笺本
page|页，页面
pain|疼痛，痛苦
painful|痛苦的，疼痛的
paint|油漆；绘画
painter|画家，油漆工
painting|绘画，油画
pair|一对，一双
palace|宫殿，宅邸
pale|苍白的，暗淡的
palm|手掌，棕榈树
pan|平底锅，盘子
panel|面，板
panic|恐慌，惊慌
paper|纸，报纸
parade|游行，检阅
paragraph|段落，节
parallel|平行的；类似的
parcel|包裹，邮包
pardon|原谅，宽恕
parent|父母亲，双亲
park|公园；停车
parliament|议会，国会
part|部分，角色
partial|部分的，偏爱的
participant|参与者，参加者
participate|参与，参加
particular|特别的，挑剔的
partly|部分地，在一定程度上
partner|伙伴，合伙人
party|聚会，党派
pass|通过；传递
passage|通道，段落
passenger|乘客，旅客
passion|激情，热情
passive|被动的，消极的
passport|护照
past|过去的；经过
paste|浆糊；粘贴
pastime|消遣，娱乐
patent|专利；专利的
path|小路，路径
patience|耐心，忍耐
patient|耐心的；病人
pattern|模式，图案
pause|暂停，停顿
pave|铺（路），铺筑
pavement|人行道
pay|支付，付款
payment|支付，付款额
pea|豌豆
peace|和平，安宁
peaceful|和平的，平静的
peak|山顶，顶点
peanut|花生
pear|梨子，梨树
pearl|珍珠，珍品
peasant|农民，佃农
peculiar|奇怪的，特殊的
pen|钢笔，圆珠笔
pencil|铅笔
penetrate|穿透，渗透
penny|便士，美分
pension|养老金，抚恤金
people|人们，人民
per|每，每一
perceive|察觉，感知
percent|百分比，百分数
percentage|百分比，百分率
perfect|完美的，极好的
perform|表演，执行
performance|表演，表现
perhaps|也许，可能
period|时期，一段时间
permanent|永久的，永恒的
permission|许可，允许
permit|许可；许可证
persist|坚持，持续
person|人，身体
personal|个人的，私人的
personnel|人事，全体人员
perspective|视角，远景
persuade|说服，劝说
pessimistic|悲观的，悲观主义的
pet|宠物；受宠爱的人
petrol|汽油
phase|阶段，相位
phenomenon|现象，奇迹
philosopher|哲学家，思想家
philosophy|哲学，人生观
phone|电话，电话机
photo|照片，相片
phrase|短语，词组
physical|身体的；物理的
physician|内科医生
physicist|物理学家
physics|物理，物理学
piano|钢琴
pick|挑选，采摘
picnic|野餐，郊游
picture|图片，照片
pie|馅饼，派
piece|片，块
pierce|刺穿，穿透
pig|猪，猪肉
pigeon|鸽子
pile|堆，大量
pill|药丸，药片
pilot|飞行员，领航员
pin|别针，大头针
pinch|捏，掐
pine|松树
pink|粉色，粉红色的
pint|品脱（容量单位）
pipe|管子，烟斗
pit|深坑，矿井
pitch|场地；音高
pity|同情，怜悯
place|地方，地点
plain|清楚的；平原
plan|计划，打算
plane|飞机；平面
planet|行星
plant|植物；工厂
plastic|塑料的；可塑的
plate|盘子，碟子
platform|平台；站台
play|玩，比赛
player|运动员，选手
playground|操场，运动场
plea|恳求，请求
plead|恳求；辩护
pleasant|令人愉快的，舒适的
please|请；使高兴
pleasure|快乐，愉快
pledge|保证，誓言
plentiful|丰富的，充足的
plenty|大量，充足
plot|情节；小块土地
plug|插头；插座
plunge|投入；使突然下降
plural|复数的；复数
plus|加；正的
pocket|口袋，钱袋
poem|诗，韵文
poet|诗人
poetry|诗歌，诗作
point|点，要点
poison|毒药；毒害
poisonous|有毒的，恶毒的
pole|杆，柱
police|警察，警方
policeman|男警察
policy|政策，方针
polish|磨光，擦亮
polite|有礼貌的，客气的
political|政治的，政治上的
politics|政治，政治活动
poll|投票，民意测验
pollute|污染，弄脏
pollution|污染，污染物
pond|池塘
pool|水池，水塘
poor|贫穷的，可怜的
pop|流行音乐；爆裂声
popular|流行的，大众的
population|人口，人数
porch|门廊，走廊
pork|猪肉
port|港口，口岸
portable|手提的，便携的
porter|搬运工，门房
portion|部分，一份
portrait|肖像，画像
position|位置，职位
positive|积极的；肯定的
possess|拥有，占有
possession|财产，所有物
possibility|可能性，可能
possible|可能的，能做到的
post|邮寄；岗位
postage|邮资，邮费
postcard|明信片
poster|海报，招贴画
postman|邮递员
postpone|推迟，延期
pot|罐，壶
potato|土豆，马铃薯
potential|潜在的；潜力
pound|磅；英镑
pour|倒，灌
poverty|贫穷，贫困
powder|粉末，粉
power|力量，权力
powerful|强有力的，强大的
practical|实际的，实用的
practice|练习，实践
praise|赞扬，表扬
pray|祈祷，恳求
prayer|祈祷，祷告
precious|珍贵的，宝贵的
precise|精确的，准确的
predict|预言，预测
prefer|更喜欢，宁愿
preference|偏爱，优先权
prejudice|偏见，成见
preliminary|初步的，预备的
premier|首要的；总理
preparation|准备，预备
prepare|准备，预备
prescribe|开（药），规定
presence|出席，存在
present|出席的；礼物
present|赠送；提出
presentation|展示，陈述
preserve|保护，保存
president|总统，校长
press|按，压
pressure|压力，压迫
pretend|假装，装作
pretty|漂亮的，可爱的
prevent|阻止，妨碍
previous|以前的，先前的
price|价格，代价
pride|骄傲，自豪
priest|牧师，神父
primary|主要的，初级的
prime|主要的，首要的
primitive|原始的，简单的
prince|王子，亲王
princess|公主，王妃
principal|校长；主要的
principle|原则，原理
print|印刷，打印
prior|优先的，在前的
prison|监狱，牢房
prisoner|囚犯，犯人
private|私人的，私有的
privilege|特权，优待
prize|奖品，奖金
probable|可能的，大概的
probably|很可能，大概
problem|问题，难题
procedure|程序，步骤
proceed|继续进行，开始
process|过程；加工
produce|生产，制造
product|产品，产物
production|生产，产量
profession|职业，专业
professional|专业的，职业的
professor|教授
profit|利润，收益
program|程序，计划
progress|进步，进展
prohibit|禁止，阻止
project|项目，工程
prominent|杰出的，突出的
promise|承诺，诺言
promote|促进，提升
prompt|提示；迅速的
pronounce|发音，宣布
proof|证据，证明
proper|适当的，正确的
property|财产，资产
proportion|比例，份额
proposal|提议，建议
propose|提议，建议
prospect|前景，前途
prosperity|繁荣，兴旺
protect|保护，保卫
protection|保护，防卫
proud|骄傲的，自豪的
prove|证明，证实
provide|提供，供给
provided|假如，倘若
province|省，省份
provision|提供，条款
psychology|心理学
public|公众的，公共的
publish|出版，发行
pull|拉，拖
pulse|脉搏；脉冲
pump|泵；打气
punch|拳打；打孔
punctual|守时的，准时的
punish|惩罚，处罚
pupil|小学生，瞳孔
purchase|购买，购置
pure|纯的，纯粹的
purple|紫色的，紫红色的
purpose|目的，意图
purse|钱包，女用小包
pursue|追求，致力于
push|推，推动
put|放，置
puzzle|谜；使困惑
qualification|资格，条件
qualify|使具有资格
quality|质量，品质
quantity|数量，量
quarter|四分之一；季度
queen|女王，王后
question|问题，疑问
questionnaire|问卷，调查表
quick|快的，迅速的
quiet|安静的，平静的
quit|停止，放弃
quite|相当，十分
quiz|测验，小考
quota|配额，限额
quote|引用，引述
rabbit|兔子，野兔
race|种族；赛跑
racial|种族的，人种的
rack|架子，挂架
radar|雷达
radiation|辐射，放射线
radio|收音机，无线电
radish|萝卜
radium|镭
radius|半径，范围
rage|愤怒，狂怒
raid|袭击，搜捕
rail|栏杆，铁轨
railroad|铁路，铁道
railway|铁路，铁道
rain|雨，雨水
rainbow|彩虹
rainy|下雨的，多雨的
raise|举起，提高
rally|集会；恢复（健康）
range|范围；一系列
rank|等级，军衔
rapid|快速的，急速的
rare|罕见的，稀有的
rarely|很少，不常
rat|老鼠，耗子
rate|比率，速度
rather|相当；宁愿
ratio|比，比率
rational|理性的，合理的
raw|生的；未加工的
ray|光线，射线
reach|到达，伸出
react|反应，起作用
read|阅读，朗读
reader|读者；读物
readily|乐意地；容易地
reading|阅读，读书
ready|准备好的，乐意的
real|真的，真实的
reality|现实，实际
realize|意识到，实现
really|真正地，确实
realm|领域，王国
rear|后面的； rear 部
reason|原因，理由
reasonable|合理的，公道的
rebel|反叛，反抗
recall|回忆，召回
receipt|收据，收条
receive|收到，接到
receiver|接收者，听筒
recent|最近的，近来的
reception|接待，接收
recession|衰退，不景气
recipe|食谱，菜谱
recognition|认出，承认
recognize|认识，承认
recommend|推荐，建议
record|记录；唱片
record|记录，记载
recorder|录音机，记录员
recover|恢复，康复
recovery|恢复，痊愈
recreation|娱乐，消遣
recruit|招募，招聘
recycle|回收利用，循环
red|红色的，红的
reduce|减少，降低
reduction|减少，降低
refer|提到，涉及
reference|参考，参照
reflect|反映，反射
reform|改革，改良
refrigerator|冰箱，冷藏库
refuge|避难，庇护
refuse|拒绝，回绝
regard|看待，认为
regarding|关于
regardless|不管，不顾
region|地区，区域
register|登记，注册
regret|遗憾，后悔
regular|规则的，定期的
regulation|规则，条例
reinforce|加强，加固
reject|拒绝，排斥
relate|联系，叙述
relation|关系，联系
relationship|关系，联系
relative|相对的；亲戚
relax|放松，休息
relay|接力赛；转播
release|释放，发布
relevant|相关的，切题的
reliable|可靠的，可信赖的
relief|减轻，救济
religion|宗教，信仰
religious|宗教的，虔诚的
reluctant|不情愿的，勉强的
rely|依靠，依赖
remain|保持，仍然
remark|评论，谈论
remarkable|非凡的，值得注意的
remember|记得，记住
remind|提醒，使想起
remote|遥远的，偏僻的
remove|移动，移开
rent|租用，出租
repair|修理，修补
repay|偿还，报答
repeat|重复，重说
repeatedly|反复地，再三地
replace|代替，替换
reply|回答，答复
report|报告，报道
represent|代表，象征
representative|代表，代理人
reproduce|复制，繁殖
republic|共和国，共和政体
reputation|名誉，声望
request|请求，要求
require|需要，要求
requirement|要求，必要条件
rescue|营救，救援
research|研究，调查
resemble|像，类似于
reserve|储备；保留
resign|辞职，放弃
resist|抵抗，抵制
resistance|抵抗，阻力
resolution|决心，决定
resolve|解决，决心
resource|资源，财力
respect|尊重，尊敬
respond|回答，响应
response|回答，响应
responsibility|责任，职责
responsible|负责的，可靠的
rest|休息；剩余部分
restaurant|餐馆，饭店
restore|恢复，修复
restrain|抑制，控制
restriction|限制，约束
result|结果，后果
resume|简历；重新开始
retail|零售
retain|保留，保持
retire|退休，离开
retreat|撤退，退却
reveal|揭示，揭露
revenue|收入，税收
reverse|颠倒，反转
review|复习；回顾
revise|修订，修改
revise|复习，温习
revolution|革命，巨变
reward|奖励，报酬
rhythm|节奏，韵律
rice|大米，米饭
rich|富有的，丰富的
rid|使摆脱，使去掉
ride|骑，乘坐
ridiculous|可笑的，荒谬的
right|正确的；右边的
ring|戒指；铃声
rise|上升，升起
risk|风险，危险
rival|竞争对手，对手
river|河流，江
road|道路，公路
roast|烤，烘烤
rob|抢劫，盗窃
robot|机器人
rock|岩石；摇动
rocket|火箭
role|角色，作用
roll|滚动；卷
roof|屋顶，顶
room|房间，空间
root|根，根源
rope|绳子，绳索
rose|玫瑰，蔷薇
rot|腐烂，腐朽
rough|粗糙的；粗略的
round|圆的；围绕
route|路线，路程
routine|例行公事，常规
row|一排，一行
royal|皇家的，王室的
rub|擦，摩擦
rubber|橡胶，橡皮
rubbish|垃圾，废物
ruby|红宝石
rug|小地毯，毛毯
ruin|毁灭，废墟
rule|规则，规定
ruler|尺子，统治者
run|跑，经营
rush|冲，奔
Russia|俄罗斯
Russian|俄罗斯的，俄语的
sack|袋子，解雇
sacred|神圣的，宗教的
sacrifice|牺牲，奉献
sad|难过的，悲伤的
saddle|马鞍
sadness|悲哀，忧伤
safe|安全的，可靠的
safety|安全，平安
sail|航行，帆
sailor|水手，海员
salad|沙拉，凉拌菜
salary|薪水，薪金
sale|出售，销售
salesman|售货员，推销员
salt|盐，盐分
salty|咸的，含盐的
same|相同的，一样的
sample|样品，样本
sand|沙，沙子
sandwich|三明治
satellite|卫星
satisfaction|满意，满足
satisfactory|令人满意的
satisfy|满足，使满意
sauce|酱汁，调味汁
saucer|茶碟，浅盘
sausage|香肠，腊肠
save|救，节省
saving|储蓄，存款
say|说，讲
scale|规模；比例尺
scan|扫描；浏览
scar|伤疤，疤痕
scarce|稀有的，罕见的
scare|惊吓，害怕
scarf|围巾，头巾
scatter|分散，撒
scene|场景，场面
scenery|风景，布景
schedule|时间表，计划表
scheme|方案，计划
scholar|学者
scholarship|奖学金；学问
school|学校，学院
science|科学，学科
scientific|科学的，系统的
scientist|科学家
scissors|剪刀
scold|责骂，训斥
scope|范围，机会
score|分数，得分
scratch|抓，搔
scream|尖叫，喊叫
screen|屏幕，银幕
screw|螺丝，旋钮
script|剧本，手稿
sea|海，海洋
seal|海豹；封条
search|搜索，寻找
season|季节，时节
seat|座位，座椅
second|第二；秒
secondary|次要的，中级的
secret|秘密，机密
secretary|秘书，书记
section|部分，部门
secure|安全的，可靠的
security|安全，保障
see|看见，明白
seed|种子
seek|寻找，寻求
seem|似乎，好像
segment|部分，片段
seize|抓住， seize
select|选择，挑选
selection|选择，挑选
self|自我，自己
sell|卖，出售
semester|学期
semi-circle|半圆
senate|参议院，大学理事会
senator|参议员
send|送，寄
senior|年长的，高级的
sense|感觉，意识
sensible|明智的，理智的
sensitive|敏感的，灵敏的
sentence|句子，判决
separate|分开的；分离
serious|严重的，严肃的
servant|仆人，佣人
serve|服务，招待
service|服务，业务
session|会议，学期
set|一套，设置
setting|环境，背景
settle|定居，解决
settlement|定居点，解决
seven|七
seventeen|十七
seventh|第七
seventy|七十
several|几个，若干
severe|严重的，严厉的
sew|缝，缝制
sex|性别
shade|阴影，阴凉处
shadow|影子，阴影
shake|摇动，震动
shall|将，会
shallow|浅的，肤浅的
shame|羞愧，遗憾的事
shape|形状，形态
share|分享，份额
sharp|锋利的；急剧的
shave|刮，剃
she|她
sheep|羊，绵羊
sheet|床单，薄片
shelf|架子，搁板
shell|壳，炮弹
shelter|庇护所，避难所
shine|发光，照耀
ship|船，舰
shirt|衬衫，衬衣
shoe|鞋，鞋底
shoot|射击，射门
shop|商店，购物
shopping|购物
shore|岸，滨
short|短的，矮的
shortcoming|缺点，短处
shot|射击， shots
should|应该，应当
shoulder|肩膀，肩部
shout|呼喊，叫喊
show|展示，演出
shower|淋浴；阵雨
shrink|收缩，缩小
shrug|耸肩
shut|关闭， shut
shy|害羞的，腼腆的
sick|生病的，恶心的
side|边，侧面
sidewalk| sidewalk (美式英语，同 pavement)
sight|视力，景象
sign|标志，迹象
signal|信号，暗号
signature|签名，署名
significance|意义，重要性
significant|重要的，有意义的
silence|沉默，寂静
silent|沉默的，安静的
silk|丝绸，丝线
silly|愚蠢的，傻的
silver|银，银器
similar|类似的，相似的
simple|简单的，简易的
simplicity|简单，朴素
simplify|简化，使简易
simply|简单地，仅仅
sin|罪，罪恶
since|自从；因为
sincere|真诚的，诚挚的
sing|唱，唱歌
single|单一的，未婚的
sink|下沉，水槽
sir|先生，阁下
sister|姐妹
sit|坐，坐落
site|地点，场所
situation|情况，形势
six|六
sixteen|十六
sixth|第六
sixty|六十
size|大小，尺寸
skate|滑冰，溜冰
skeleton|骨架，骨骼
sketch|素描，草图
ski|滑雪，滑雪板
skill|技能，技巧
skilled|熟练的，有技能的
skillful|灵巧的，熟练的
skin|皮肤，皮
skip|跳过，略过
skirt|裙子
sky|天空，天
slack|松弛的；懈怠的
slam|砰地关上
slap|掌掴，拍打
slave|奴隶，苦工
sleep|睡觉，睡眠
slice|薄片，切片
slide|滑动，滑梯
slight|轻微的，纤细的
slightly|稍微，略微
slim|苗条的，修长的
sling|吊索， sling
sink|下沉，水槽
sir|先生，阁下
sister|姐妹
sit|坐，坐落
site|地点，场所
situation|情况，形势
six|六
sixteen|十六
sixth|第六
sixty|六十
size|大小，尺寸
skate|滑冰，溜冰
skeleton|骨架，骨骼
sketch|素描，草图
ski|滑雪，滑雪板
skill|技能，技巧
skilled|熟练的，有技能的
skillful|灵巧的，熟练的
skin|皮肤，皮
skip|跳过，略过
skirt|裙子
sky|天空，天
slack|松弛的；懈怠的
slam|砰地关上
slap|掌掴，拍打
slave|奴隶，苦工
sleep|睡觉，睡眠
slice|薄片，切片
slide|滑动，滑梯
slight|轻微的，纤细的
slightly|稍微，略微
slim|苗条的，修长的
sling|吊索， sling
slow|慢的，缓慢的
slum|贫民窟
sly|狡猾的，狡诈的
small|小的，少的
smart|聪明的，时髦的
smash|打碎，撞击
smell|气味；嗅觉
smile|微笑，笑容
smog|烟雾，雾霾
smoke|烟，烟雾
smooth|光滑的，平稳的
snake|蛇，阴险的人
snap|折断，猛咬
snow|雪，下雪
snowy|下雪的，多雪的
so|所以，如此
soak|浸泡，浸湿
soap|肥皂
sob|抽泣，哭泣
social|社会的，社交的
socialist|社会主义者
society|社会，社团
sock|短袜
socket|插座，孔
soft|软的，柔软的
software|软件
soil|土壤，土地
solar|太阳的，太阳能的
soldier|士兵，军人
sole|脚底；唯一的
solemn|庄严的，隆重的
solid|固体的；结实的
solution|解决方案，溶液
solve|解决，解答
some|一些，某些
somebody|某人，有人
somehow|不知怎么地
someone|某人，有人
something|某事，某物
sometimes|有时，偶尔
somewhat|稍微，有点
somewhere|在某处，某地
son|儿子
song|歌曲，歌声
soon|很快，不久
sophisticated|复杂的，老练的
sore|疼痛的，酸痛的
sorrow|悲伤，悲痛
sorry|对不起的，抱歉的
sort|种类，类别
soul|灵魂，心灵
sound|声音，听起来
soup|汤，羹
source|来源，出处
south|南，南方
southeast|东南
southern|南方的，南部的
southwest|西南
sow|播种，散布
space|空间，太空
spade|铲子，铁锹
span|跨度，范围
Spanish|西班牙的，西班牙语的
spare|多余的；备用的
speak|说，讲
speaker|演讲者，扬声器
special|特别的，专门的
specialist|专家
specialize|专门从事
species|物种，种类
specific|具体的，明确的
specify|指定，详细说明
speech|演讲，言语
speed|速度，迅速
spell|拼写，拼出
spelling|拼写，拼法
spend|花费，度过
sphere|球体，范围
spider|蜘蛛
spill|溢出，洒落
spin|旋转， spinning
spirit|精神，灵魂
spiritual|精神的，心灵的
spit|吐痰，吐口水
splash|溅起，泼洒
split|分裂，分开
spoil|宠坏；变质
spoke|轮辐， spoke
spoken|口头的，口语的
sponsor|赞助者，主办者
spoon|勺子，匙
sport|运动，游戏
spot|地点，斑点
spray|喷雾，喷洒
spread|传播，展开
spring|春天，弹簧
square|平方；广场
squeeze|挤压，榨取
stability|稳定性，稳固
stable|稳定的，牢固的
stadium|体育场
staff|全体职员， staff
stage|阶段，舞台
stain|污点，染色
stair|楼梯，阶梯
stake|桩，赌注
stale|不新鲜的，陈腐的
stamp|邮票；跺脚
stand|站立，忍受
standard|标准，规格
star|星星，明星
stare|凝视，注视
start|开始，出发
starve|挨饿，饿死
state|状态；国家
statement|声明，陈述
statesman|政治家
static|静态的，静止的
station|车站，局
statistic|统计数值
status|地位，状态
stay|停留，逗留
steady|稳定的，稳固的
steak|牛排，肉排
steal|偷窃，偷盗
steam|蒸汽，水汽
steel|钢铁，钢
steep|陡峭的，险峻的
steer|驾驶，引导
stem|茎，干
step|步，台阶
stereotype|刻板印象
stick|棍棒；粘住
sticky|粘的，粘性的
stiff|僵硬的；艰难的
still|仍然，依旧
stimulate|刺激，激励
sting|刺，叮
stir|搅拌，搅动
stock|库存，股票
stocking|长筒袜
stomach|胃，肚子
stone|石头，宝石
stool|凳子， stool
stop|停止，车站
storage|存储，仓库
store|商店；存储
storm|暴风雨，风暴
story|故事，小说
stove|炉子，火炉
straight|直的，直接的
strain|拉紧； strain
strange|奇怪的，陌生的
stranger|陌生人
strap|带子，皮带
strategy|策略，战略
straw|稻草，吸管
strawberry|草莓
stream|小溪，流
street|街道，马路
strength|力量，优点
strengthen|加强，增强
stress|压力，强调
stretch|伸展，延伸
strict|严格的，严厉的
strike|打，袭击
striking|显著的，惊人的
string|线，字符串
strip| strips；剥去
stripe|条纹，斑纹
stroke|一击；中风
strong|强壮的，强烈的
structure|结构，构造
struggle|斗争，挣扎
student|学生
studio|工作室，画室
study|学习，研究
stuff|东西，物品
stupid|愚蠢的，笨的
style|风格，样式
subject|主题；学科
subject|使服从
substance|物质，实质
substantial|大量的，坚固的
substitute|代替者，代替品
subtract|减去，扣除
suburb|郊区，城郊
subway|地铁
succeed|成功，继承
success|成功，胜利
successful|成功的，有成就的
succession|连续，继任
such|这样的，如此的
suck|吸，吮吸
sudden|突然的，意外的
suffer|遭受，忍受
sufficient|足够的，充足的
sugar|糖
suggest|建议，暗示
suggestion|建议，提议
suicide|自杀
suit|一套衣服；诉讼
suitable|合适的，适宜的
suite|套房，套件
sum|总数，金额
summary|总结，摘要
summer|夏天，夏季
sun|太阳，阳光
Sunday|星期日
sunlight|阳光，日光
sunny|阳光充足的，晴朗的
sunrise|日出，黎明
sunset|日落，傍晚
sunshine|阳光，日照
super|超级的，极好的
superior|上级的；优越的
supermarket|超市，超级市场
supper|晚餐，晚饭
supplement|增补，补充
supply|供应，补给
support|支持，拥护
supporter|支持者，拥护者
suppose|假设，认为
suppress|镇压，抑制
supreme|最高的，至上的
sure|确信的，有把握的
surface|表面，外表
surgeon|外科医生
surgery|外科，手术
surprise|惊奇，惊喜
surprised|感到惊讶的
surprising|令人惊讶的
surround|包围，环绕
surroundings|环境，周围事物
survey|调查，测量
survival|幸存，生存
survive|幸存，存活
suspect|怀疑，嫌疑犯
suspend|暂停，悬架
suspicion|怀疑，猜疑
suspicious|可疑的，怀疑的
sustain|维持，支撑
swallow|燕子；吞下
swear|发誓，咒骂
sweat|汗水，出汗
sweater|毛衣，运动衫
sweep|打扫，清扫
sweet|甜的，可爱的
swell|肿胀，膨胀
swift|迅速的，敏捷的
swim|游泳，游动
swing|摇摆，秋千
switch|开关，转换
sword|剑，刀
symbol|符号，象征
sympathetic|同情的，有同情心的
sympathy|同情，同情心
symphony|交响乐，交响曲
symptom|症状，征兆
system|系统，体系
table|桌子，表格
tablet|药片，牌匾
tag|标签，标记
tail|尾巴，尾部
tailor|裁缝
take|拿，取
tale|故事，传说
talent|天赋，才能
talk|谈话，交谈
tall|高的，高大的
tank|坦克；水槽
tap|水龙头；轻拍
tape|磁带，胶带
target|目标，靶子
task|任务，工作
taste|味道，品味
tax|税，税收
taxi|出租车，计程车
tea|茶，茶叶
teach|教，教导
teacher|教师，老师
teaching|教学，教导
team|队，组
tear|眼泪；撕裂
technical|技术的，工艺的
technician|技术员，技师
technique|技术，方法
technology|技术，工艺
tedious|冗长乏味的，沉闷的
teenager|青少年，十几岁的孩子
telegram|电报
telephone|电话，电话机
telescope|望远镜
television|电视，电视机
tell|告诉，讲述
temper|脾气，情绪
temperature|温度，气温
temple|寺庙，神殿
temporary|暂时的，临时的
tempt|引诱，诱惑
ten|十
tend|趋向，倾向
tendency|趋势，倾向
tender|温柔的；嫩的
tense|紧张的；时态
tent|帐篷
term|学期；术语
terrible|糟糕的，可怕的
territory|领土，版图
terror|恐怖，恐惧
test|测试，考试
text|文本，课文
textbook|教科书，课本
than|比
thank|感谢，谢谢
that|那，那个
the|这，那（定冠词）
theatre|剧院，戏院
their|他们的，她们的
them|他们，她们
theme|主题，题目
themselves|他们自己
then|然后，当时
theoretical|理论的，假设的
theory|理论，学说
there|那里，那儿
therefore|因此，所以
thermometer|温度计，体温计
these|这些
they|他们，她们
thick|厚的，浓的
thin|薄的，瘦的
thing|东西，事物
think|想，认为
third|第三
thirst|渴，口渴
thirsty|渴的，口渴的
thirteen|十三
thirty|三十
this|这，这个
those|那些
though|虽然，尽管
thought|思想，想法
thousand|一千
thread|线，线索
threat|威胁，恐吓
threaten|威胁，恐吓
three|三
thrill|激动，兴奋
throat|喉咙，咽喉
through|通过，穿过
throughout|遍及，贯穿
throw|扔，投
thrust|推力；刺
thumb|拇指
thus|因此，从而
ticket|票，券
tide|潮汐，潮流
tie|领带；系
tiger|老虎
tight|紧的，牢固的
till|直到，除非
time|时间，次数
tin|锡，罐头
tiny|微小的，极小的
tip|小费；尖端
tire|轮胎；使疲劳
tired|疲劳的，累的
tissue|组织，薄纸
title|标题，头衔
to|到，向
toast|烤面包；干杯
today|今天，现在
toe|脚趾，足尖
together|一起，共同
toilet|厕所，洗手间
token|代币；象征
tolerate|容忍，忍受
tomato|番茄，西红柿
tomorrow|明天，未来
ton|吨
tone|语气，音调
tongue|舌头，语言
tonight|今晚，今夜
too|也，太
tool|工具，器具
tooth|牙齿
toothache|牙痛
toothbrush|牙刷
toothpaste|牙膏
top|顶部，顶端
topic|话题，主题
torch|手电筒，火炬
tortoise|乌龟，迟缓的人
total|总计的；总数
touch|触摸，接触
tough|艰难的；强硬的
tour|旅游，旅行
tourist|游客，旅行者
tournament|锦标赛，联赛
toward|朝向，关于
towel|毛巾，手巾
tower|塔，高楼
town|城镇，市镇
toy|玩具，玩物
trace|痕迹，踪迹
track|轨道；足迹
tractor|拖拉机
trade|贸易，交易
tradition|传统，惯例
traditional|传统的，惯例的
traffic|交通，流量
train|火车；训练
trainer|训练员，教练
training|训练，培养
transfer|转移，调动
transform|转换，变形
transformation|转换，变形
translate|翻译
translation|翻译，译文
transmission|传输，传播
transmit|传输，发射
transport|运输，运送
transportation|运输，交通
trap|陷阱，圈套
travel|旅行，游历
tray|托盘，碟子
treasure|财富，珍宝
treat|对待，治疗
treatment|治疗，待遇
treaty|条约，协议
tree|树，树木
tremble|颤抖，发抖
tremendous|巨大的，惊人的
trend|趋势，倾向
trial|审判，试验
triangle|三角形，三角形物体
trick|诡计，把戏
trip|旅行，旅程
triple|三倍的； triple
triumph|胜利，成功
troop|部队，一群
trouble|麻烦，困难
trousers|裤子
truck|卡车，货车
true|真实的，正确的
trust|信任，信赖
truth|真相，事实
try|尝试，努力
tube|管子，地铁（英）
Tuesday|星期二
tune|曲调， tune
turn|转动，轮流
twelve|十二
twenty|二十
twice|两次，两倍
twin|双胞胎之一
twist|扭曲，拧
two|二
ugly|丑陋的，难看的
ultimate|最终的，极致的
umbrella|雨伞
unable|不能的，不会的
uncle|叔叔，舅舅
uncomfortable|不舒服的
under|在……下面
understand|理解，明白
understanding|理解，谅解
unfair|不公平的
unfortunate|不幸的
unhappy|不快乐的
uniform|制服，统一
union|联盟，工会
unique|独特的，唯一的
unit|单位，单元
unite|联合，团结
universe|宇宙
university|大学
unless|除非
until|直到……为止
up|向上，在上面
upon|在……之上（较正式）
upper|上面的，上部的
upset|心烦的；打翻
upstairs|在楼上
upward|向上的
urban|城市的，都市的
urge|催促，强烈欲望
urgent|紧急的，急迫的
us|我们（宾格）
use|使用，用途
used|用过的，习惯的
useful|有用的，有益的
user|用户，使用者
usual|通常的，平常的
vacation|假期（美式）/ 假期（英式常用 holiday）
vague|模糊的，不明确的
valid|有效的，合理的
valley|山谷
valuable|有价值的，贵重的
value|价值，重视
van|厢式货车，面包车
variety|多样性，种类
various|各种各样的
vary|变化，不同
vast|巨大的，广阔的
vegetable|蔬菜
vehicle|车辆，交通工具
version|版本，说法
very|非常，很
vessel|船，容器
veteran|老兵，老手
via|经由，通过
victim|受害者
victory|胜利
video|视频，录像
view|看法，景色
village|村庄
violate|违反，侵犯
violence|暴力
violent|暴力的，猛烈的
virtue|美德，优点
virus|病毒
visa|签证
visible|可见的
vision|视力，视野
visit|访问，参观
visitor|访客，游客
visual|视觉的
vital|至关重要的
voice|声音，嗓音
volume|体积，音量
volunteer|志愿者，自愿者
vote|投票，选举
wage|工资，报酬
wait|等待
waiter|男服务员
waitress|女服务员
wake|醒来，唤醒
walk|走路，散步
wall|墙
wallet|钱包
want|想要，需要
war|战争
warm|温暖的，热情的
warn|警告，提醒
warning|警告，告诫
wash|洗，洗涤
washing|洗涤，洗衣服
waste|浪费，废物
watch|手表；观看
water|水
wave|波浪，挥手
way|方法，道路
we|我们
weak|虚弱的，弱的
wealth|财富，财产
wealthy|富有的
weapon|武器
wear|穿，戴
weather|天气
wedding|婚礼
Wednesday|星期三
week|周，星期
weekend|周末
weekly|每周的
weigh|称重，重量为
weight|重量，分量
welcome|欢迎
well|好地；井
west|西，西方
western|西方的
wet|湿的，潮湿的
whale|鲸鱼
what|什么
whatever|无论什么
wheel|轮子
when|什么时候，当……时
whenever|无论何时
where|哪里
wherever|无论哪里
whether|是否
which|哪一个
while|当……时候；而
whisper|低语，耳语
white|白色的，白人
who|谁
whole|整个的，完整的
whom|谁（宾格）
whose|谁的
why|为什么
wide|宽的，广泛的
widely|广泛地
wife|妻子
wild|野生的，狂野的
will|将，会；意志
willing|愿意的
win|赢，获胜
wind|风； winding
window|窗户
wine|葡萄酒
wing|翅膀，机翼
winner|赢家，获胜者
winter|冬天，冬季
wipe|擦，拭
wire|电线，金属丝
wise|聪明的，明智的
wish|希望，愿望
with|和……一起，带有
within|在……之内
without|没有
wolf|狼
woman|女人（复数 women）
wonder|奇迹；想知道
wonderful|极好的，精彩的
wood|木头，树林
wool|羊毛
word|词，话语
work|工作，劳动
worker|工人，工作者
world|世界
worried|担心的，焦虑的
worry|担忧，烦恼
worse|更糟的（bad 的比较级）
worst|最糟的（bad 的最高级）
worth|值得的，价值
would|将，愿意（will 的过去式）
wound|伤口，伤害
wrap|包裹，包起来
wrist|手腕
write|写，书写
writer|作家，作者
writing|写作，笔迹
wrong|错误的，不公正的
x-ray|X光，X射线
yard|院子，码（长度单位）
year|年
yellow|黄色的
yes|是，是的
yesterday|昨天
yet|还，已经（用于否定或疑问）
you|你，你们
young|年轻的
your|你的，你们的
yours|你的（东西），你们的（东西）
yourself|你自己
youth|青年，青春
zebra|斑马
zero|零
zip|拉链；压缩
zone|区域，地带
zoo|动物园